30 100
GTGTTTAGGTATGTAATCATAACGCCGTCA|ATGTAATCCTTGCATTCCTGTAATCCGTAT
CAGTCCATTCGCCCATGCTGGCGCCTCGGC|CAATAAACTGGAGGCCAGCCTTTAAAAGAG
AAGCTACCAAATTTTTACTACAATCGTTGC|GGAGTATCAACCCGAAAGTTTGATTAGAAT
TAGGTATGTAATCGCATCCGGAGTTCGTGT|AACGCATCCGGAGTTCGTGTTTAGGTATGT
CAGCCTTTAAAAGAGGGGTAAGTCCTGTAC|TCCGGAGTTCGTGTTTAGGTATGTAATGGA
CCGGCGGGTCTGCGCCTTCCGAGGGTTATC|TAGGTGAAGCTACCAAATTTTTACTACAAT
TGTGGCAGATATGTGGAGTATCAACCCGAA|GGTACTCGTGCAATTTCGAGTATTGGTCCA
GAGGGGTAAGTCCTGTACTCGCATAGAGAA|GTTTAGGTATGTAATGGATCGAGCCTCGAT
TTTCGTAAAGTCGAGGGTAACCTCCTAGGC|TAATAGTACCCCCTGGCAATCATGTTATTA
TCCGGAGACCTCCCGTCGAAGGATGCTGTA|GCATCCGGAGTTCGTGTTTAGGTATGTAAT
GGGTCAATCCGGCGGGTCTGCGCCTTCCGA|ATTGCAGTTAGGTGAAGCTACCAAATTTTT
GGCCAGCCTTTAAAAGAGGGGTAAGTCCTG|GCATCCGGAGTTCGTGTTTAGGTATGTAAT
ATATGTGGAGTATCAACCCGAAAGTTTGAT|TGCAATTTCGAGTATTGGTCCACTATCACG
CGTTGCTGTGCGGTAGAGAGGCCCGGGCAT|TCCGGAGTTCGTGTTTAGGTATGTAATCGG
GCGCTTTGACCGTTGCTGTGCGGTAGAGAG|AGGCATCGCATCCGGAGTTCGTGTTTAGGT
AATCACGGTTGTCCGCATTAGAGGGAGTCA|TACAACGGGAATACGTGCGATCTATTTCAT
TCGCGTGTCCCCCCACAGGAATCACGGTTG|GGACCGCCATGTTAGGCCTTACAACGGGAA
GCTGGCGCCTCGGCATCCGGAGTTCGTGTT|AGCCTTTAAAAGAGGGGTAAGTCCTGTACT
TAGGTAGGTGCTGGCCACCTAGATGTACGG|GGAGTTCGTGTTTAGGTATGTAATAGCATC
ACGGACCCGTCTCGGGGATCCCCACTTGGG|CATCCGGAGTTCGTGTTTAGGTATGTAATT
ATGTAATAGGTATGTAATTGCGCCGCATCC|TCCGCATTAGAGGGAGTCAGAGATGAAATA
CCCGCATCCGGAGTTCGTGTTGCATCCGGA|AGTTCGTGTTTAGGTATGTAATGACGTTGT
CTGCGCCTTCCGAGGGTTATCACGCACAGT|CTACCAAATTTTTACTACAATCGTTGCAAT
TCGTTAGTGGCTTTAGGTAGGTGCTGGCCA|CGCCTCGGCATCCGGAGTTCGTGTTTAGGT
ACTATCTGCATACCCAATTATTCGGTACTC|TTATTTGGTATCCCTATGGAGGCATCCGGA
GCTTTGACCGTTGCTGTGCGGTAGAGAGGC|GCATCGCATCCGGAGTTCGTGTTTAGGTAT
CGAGCTCCGCATCCGGAGTTCGTGTTTGCA|GTAATCATAACGCCGTCAGGTCGCGTGTCC
CCGCATCCGGAGTTCGTGTTGCATCCGGAG|GTTCGTGTTTAGGTATGTAATGACGTTGTT
CGGAGTTCGTGTTTGCATCCGGAGTTCGTG|CGTCAGGTCGCGTGTCCCCCCACAGGAATC
TAAAACTAATTGATGCATCCGGAGTTCGTG|AGGTAAGATTAGCGCTTTGACCGTTGCTGT
CATAACCAGGCGAGGATGTAGGTGACATAG|TAATCGCATCCGGAGTTCGTGTTTAGGTAT
AATCGCATCCGGAGTTCGTGTTTAGGTATG|GGAGTTCGTGTTTAGGTATGTAATCCTTGC
CACGAACAGCGGCTTGGGTGTCAGGCTTCT|ATCGCACAGTATGACTAAAACTAATTGATG
CTGCATACCCAATTATTCGGTACTCGTGCA|TGGTATCCCTATGGAGGCATCCGGAGTTCG
TATGTGGAGTATCAACCCGAAAGTTTGATT|GCAATTTCGAGTATTGGTCCACTATCACGA
AGATTAGCGCTTTGACCGTTGCTGTGCGGT|CCTCCTAGGCATCGCATCCGGAGTTCGTGT
ACGATGCCCGCATCCGGAGTTCGTGTTGCA|ATCCGGAGTTCGTGTTTAGGTATGTAATGA
AGTTCGTGTTTAGGTATGTAATCGCATCCG|TCACCAATGTAACGCATCCGGAGTTCGTGT
TCCCCCCACAGGAATCACGGTTGTCCGCAT|CATGTTAGGCCTTACAACGGGAATACGTGC
GTCAGGTCGCGTGTCCCCCCACAGGAATCA|GTATCTGGACCGCCATGTTAGGCCTTACAA
CTTTTAATCGACTTTGGTCCGAGAATCGTT|CGCACAGTCCATTCGCCCATGCTGGCGCCT
AAGGATGCTGTAATAGTACCCCCTGGCAAT|TAGGTATGTAATAGGTATGTAATTGCGCCG
TTAAAAGAGGGGTAAGTCCTGTACTCGCAT|GTTCGTGTTTAGGTATGTAATGGATCGAGC
GAGTTCGTGTTTAGGTATGTAATTCACGTA|GGTGACATAGCGAGCTCCGCATCCGGAGTT
TATGTAATGGAGCGCGAGTGAGGTAAGATT|GTAGGTTTCGTAAAGTCGAGGGTAACCTCC
GAGTTCGTGTTTAGGTATGTAATAATCTAC|CGTTGCTGTGCGGTAGAGAGGCCCGGGCAT
TCCCTATGGAGGCATCCGGAGTTCGTGTTT|TTCGTGTTGCATCCGGAGTTCGTGTTTAGG
AACTGGAGGCCAGCCTTTAAAAGAGGGGTA|CTGACTTGCATCCGGAGTTCGTGTTTAGGT
TTAGTGGCTTTAGGTAGGTGCTGGCCACCT|CTCGGCATCCGGAGTTCGTGTTTAGGTATG
CGTATGTCGCGTCCGGAGACCTCCCGTCGA|AGTTCGTGTTTGCATCCGGAGTTCGTGTTT
TGGCCACCTAGATGTACGGACCCGTCTCGG|TTAGGTATGTAATAGCATCCGGAGTTCGTG
AGGTCGCGTGTCCCCCCACAGGAATCACGG|TCTGGACCGCCATGTTAGGCCTTACAACGG
CCCCCCACAGGAATCACGGTTGTCCGCATT|ATGTTAGGCCTTACAACGGGAATACGTGCG
TAGAGAGGCCCGGGCATCCGGAGTTCGTGT|TTTAGGTATGTAATCGGAGTTCGTGTTTAG
TTGCTGTGCGGTAGAGAGGCCCGGGCATCC|CGGAGTTCGTGTTTAGGTATGTAATCGGAG
GCCCATGCTGGCGCCTCGGCATCCGGAGTT|GAGGCCAGCCTTTAAAAGAGGGGTAAGTCC
TGTGCGGTAGAGAGGCCCGGGCATCCGGAG|GTTCGTGTTTAGGTATGTAATCGGAGTTCG
GTCTGCGCCTTCCGAGGGTTATCACGCACA|AGCTACCAAATTTTTACTACAATCGTTGCA
ATCAACCCGAAAGTTTGATTAGAATGAATC|GTATTGGTCCACTATCACGAACAGCGGCTT
AATCGTTGCAATAAACTGGAGGCCAGCCTT|GATTAGAATGAATCTGACTTGCATCCGGAG
CTACGATGCCCGCATCCGGAGTTCGTGTTG|GCATCCGGAGTTCGTGTTTAGGTATGTAAT
TTGACCGTTGCTGTGCGGTAGAGAGGCCCG|TCGCATCCGGAGTTCGTGTTTAGGTATGTA
ATCCGGAGTTCGTGTTTAGGTATGTAATCG|AATATATCACCAATGTAACGCATCCGGAGT
AAGAGGCATAACCAGGCGAGGATGTAGGTG|GGTATGTAATCGCATCCGGAGTTCGTGTTT
GAAGGATGCTGTAATAGTACCCCCTGGCAA|TTAGGTATGTAATAGGTATGTAATTGCGCC
TTCGGTACTCGTGCAATTTCGAGTATTGGT|GGCATCCGGAGTTCGTGTTTAGGTATGTAA
TGTCCCCCCACAGGAATCACGGTTGTCCGC|GCCATGTTAGGCCTTACAACGGGAATACGT
TTAGGTATGTAATAGCATCCGGAGTTCGTG|TCGCATAGAGAAACATATGATCCCATGGAC
AAGTTTGATTAGAATGAATCTGACTTGCAT|ACTATCACGAACAGCGGCTTGGGTGTCAGG
TCGCCCATGCTGGCGCCTCGGCATCCGGAG|TGGAGGCCAGCCTTTAAAAGAGGGGTAAGT
TGTTTAGGTATGTAATCGGAGTTCGTGTTT|TAACCAGGCGAGGATGTAGGTGACATAGCG
TTCGTGTTTAGGTATGTAATAATCTACGAT|TGCTGTGCGGTAGAGAGGCCCGGGCATCCG
AGGCCAGCCTTTAAAAGAGGGGTAAGTCCT|TGCATCCGGAGTTCGTGTTTAGGTATGTAA
GAATGAATCTGACTTGCATCCGGAGTTCGT|CAGCGGCTTGGGTGTCAGGCTTCTGCACCT
ATAACGCCGTCAGGTCGCGTGTCCCCCCAC|TGTAATCCGTATCTGGACCGCCATGTTAGG
TTGTTTTACTCTTCTGGGTGCGAACGCCCG|GTCGCGTCCGGAGACCTCCCGTCGAAGGAT
GCTCCGCATCCGGAGTTCGTGTTTGCATCC|ATCATAACGCCGTCAGGTCGCGTGTCCCCC
GAATCTGACTTGCATCCGGAGTTCGTGTTT|GGCTTGGGTGTCAGGCTTCTGCACCTTAGG
AAATGCAAGAGGCATAACCAGGCGAGGATG|TGTTTAGGTATGTAATCGCATCCGGAGTTC
GAGAAACATATGATCCCATGGACTAGAATA|TCGATACAGTTTACTATCTGCATACCCAAT
TCGAGTATTGGTCCACTATCACGAACAGCG|TTAGGTATGTAATCCATAAATCGCACAGTA
GGTAAGTCCTGTACTCGCATAGAGAAACAT|AGGTATGTAATGGATCGAGCCTCGATACAG
ACTCAGACTTCGCCCCATTATTTGGTATCC|AATAATCTACGATGCCCGCATCCGGAGTTC
GCCTTTAAAAGAGGGGTAAGTCCTGTACTC|CGGAGTTCGTGTTTAGGTATGTAATGGATC
TCATAACGCCGTCAGGTCGCGTGTCCCCCC|CCTGTAATCCGTATCTGGACCGCCATGTTA
GTAAAGTCGAGGGTAACCTCCTAGGCATCG|AGTACCCCCTGGCAATCATGTTATTACACA
GACTTTGGTCCGAGAATCGTTAGTGGCTTT|CATTCGCCCATGCTGGCGCCTCGGCATCCG
TACTCAGACTTCGCCCCATTATTTGGTATC|TAATAATCTACGATGCCCGCATCCGGAGTT
TCCGCATCCGGAGTTCGTGTTTGCATCCGG|CATAACGCCGTCAGGTCGCGTGTCCCCCCA
TGCGCCTTCCGAGGGTTATCACGCACAGTC|TACCAAATTTTTACTACAATCGTTGCAATA
GGGTCTGCGCCTTCCGAGGGTTATCACGCA|GAAGCTACCAAATTTTTACTACAATCGTTG
TTGCATCCGGAGTTCGTGTTTAGGTATGTA|AATGACGTTGTTTTACTCTTCTGGGTGCGA
TTTGCATCCGGAGTTCGTGTTTAGGTATGT|GTGTCCCCCCACAGGAATCACGGTTGTCCG
TTCCGAGGGTTATCACGCACAGTCCATTCG|ATTTTTACTACAATCGTTGCAATAAACTGG
GTATGTAATAATCTACGATGCCCGCATCCG|AGAGAGGCCCGGGCATCCGGAGTTCGTGTT
CGAGGATGTAGGTGACATAGCGAGCTCCGC|CGGAGTTCGTGTTTAGGTATGTAATCATAA
CCCACAGGAATCACGGTTGTCCGCATTAGA|TTAGGCCTTACAACGGGAATACGTGCGATC
CTCGGCATCCGGAGTTCGTGTTTAGGTATG|AAAGAGGGGTAAGTCCTGTACTCGCATAGA
ACCAGGCGAGGATGTAGGTGACATAGCGAG|CGCATCCGGAGTTCGTGTTTAGGTATGTAA
ATACAGTTTACTATCTGCATACCCAATTAT|TTCGCCCCATTATTTGGTATCCCTATGGAG
CACGCACAGTCCATTCGCCCATGCTGGCGC|TCGTTGCAATAAACTGGAGGCCAGCCTTTA
CAATCCGGCGGGTCTGCGCCTTCCGAGGGT|CAGTTAGGTGAAGCTACCAAATTTTTACTA
TGCTGGCCACCTAGATGTACGGACCCGTCT|TGTTTAGGTATGTAATAGCATCCGGAGTTC
GGAGTTCGTGTTTAGGTATGTAATCCATAA|GTTCGTGTTTAGGTATGTAATTAGGTATGT
ATCTACGATGCCCGCATCCGGAGTTCGTGT|GGGCATCCGGAGTTCGTGTTTAGGTATGTA
CCTTCCGAGGGTTATCACGCACAGTCCATT|AAATTTTTACTACAATCGTTGCAATAAACT
TGCATCCGGAGTTCGTGTTTAGGTATGTAA|GTCCCCCCACAGGAATCACGGTTGTCCGCA
TAGGTATGTAATAATCTACGATGCCCGCAT|GGTAGAGAGGCCCGGGCATCCGGAGTTCGT
AGAGGCATAACCAGGCGAGGATGTAGGTGA|GTATGTAATCGCATCCGGAGTTCGTGTTTA
TCGGCATCCGGAGTTCGTGTTTAGGTATGT|AAGAGGGGTAAGTCCTGTACTCGCATAGAG
GGTATGTAATCGCATCCGGAGTTCGTGTTT|CGCATCCGGAGTTCGTGTTTAGGTATGTAA
GACTACTCAGACTTCGCCCCATTATTTGGT|ATGTAATAATCTACGATGCCCGCATCCGGA
TCAGGTCGCGTGTCCCCCCACAGGAATCAC|TATCTGGACCGCCATGTTAGGCCTTACAAC
AATGGATCGAGCCTCGATACAGTTTACTAT|GAGGGACTACTCAGACTTCGCCCCATTATT
GCGGTAGAGAGGCCCGGGCATCCGGAGTTC|CGTGTTTAGGTATGTAATCGGAGTTCGTGT
CAAATTTTTACTACAATCGTTGCAATAAAC|CAACCCGAAAGTTTGATTAGAATGAATCTG
ACGTTGTTTTACTCTTCTGGGTGCGAACGC|TATGTCGCGTCCGGAGACCTCCCGTCGAAG
GGCATCCGGAGTTCGTGTTTAGGTATGTAA|ATCGGAGTTCGTGTTTAGGTATGTAATTCA
GAGTTCGTGTTTAGGTATGTAATGACGTTG|TCGTGTTTAGGTATGTAATTCACGTATGTC
GGAGTTCGTGTTTAGGTATGTAATAGGTAT|CACAGGAATCACGGTTGTCCGCATTAGAGG
TACGGACCCGTCTCGGGGATCCCCACTTGG|GCATCCGGAGTTCGTGTTTAGGTATGTAAT
CGTCTCGGGGATCCCCACTTGGGTCAATCC|AGTTCGTGTTTAGGTATGTAATTGCAGTTA
CGAGGGTAACCTCCTAGGCATCGCATCCGG|CCTGGCAATCATGTTATTACACAAATGCAA
CACAGGAATCACGGTTGTCCGCATTAGAGG|AGGCCTTACAACGGGAATACGTGCGATCTA
GGGATCCCCACTTGGGTCAATCCGGCGGGT|GTTTAGGTATGTAATTGCAGTTAGGTGAAG
GAGGGTAACCTCCTAGGCATCGCATCCGGA|CTGGCAATCATGTTATTACACAAATGCAAG
ATACCCAATTATTCGGTACTCGTGCAATTT|ATCCCTATGGAGGCATCCGGAGTTCGTGTT
ATCCCATGGACTAGAATAACCAGTGTGGCA|ACTATCTGCATACCCAATTATTCGGTACTC
GCATAACCAGGCGAGGATGTAGGTGACATA|GTAATCGCATCCGGAGTTCGTGTTTAGGTA
ATCATAACGCCGTCAGGTCGCGTGTCCCCC|TCCTGTAATCCGTATCTGGACCGCCATGTT
CGGTACTCGTGCAATTTCGAGTATTGGTCC|CATCCGGAGTTCGTGTTTAGGTATGTAATC
ATGACTAAAACTAATTGATGCATCCGGAGT|GAGTGAGGTAAGATTAGCGCTTTGACCGTT
TGTAATGGATCGAGCCTCGATACAGTTTAC|TGTGAGGGACTACTCAGACTTCGCCCCATT
CACTTGGGTCAATCCGGCGGGTCTGCGCCT|ATGTAATTGCAGTTAGGTGAAGCTACCAAA
TGGCAGATATGTGGAGTATCAACCCGAAAG|TACTCGTGCAATTTCGAGTATTGGTCCACT
AGGTATGTAATAATCTACGATGCCCGCATC|GTAGAGAGGCCCGGGCATCCGGAGTTCGTG
GAGTATTGGTCCACTATCACGAACAGCGGC|AGGTATGTAATCCATAAATCGCACAGTATG
AGGGTTATCACGCACAGTCCATTCGCCCAT|TACTACAATCGTTGCAATAAACTGGAGGCC
AGGTATGTAATTGCGCCGCATCCGGAGTTC|TAGAGGGAGTCAGAGATGAAATATATCACC
AACCAGGCGAGGATGTAGGTGACATAGCGA|TCGCATCCGGAGTTCGTGTTTAGGTATGTA
CTGCACCTTAGGCGCCCTGTGAGGGACTAC|TGCATCCGGAGTTCGTGTTTAGGTATGTAA
AGGATGTAGGTGACATAGCGAGCTCCGCAT|GAGTTCGTGTTTAGGTATGTAATCATAACG
GGATGTAGGTGACATAGCGAGCTCCGCATC|AGTTCGTGTTTAGGTATGTAATCATAACGC
TAGAGAAACATATGATCCCATGGACTAGAA|CCTCGATACAGTTTACTATCTGCATACCCA
TCGTGTTTAGGTATGTAATCCATAAATCGC|TGTTTAGGTATGTAATTAGGTATGTAATGG
TTTAGGTATGTAATCGCATCCGGAGTTCGT|GTAACGCATCCGGAGTTCGTGTTTAGGTAT
AGTTCGTGTTGCATCCGGAGTTCGTGTTTA|AGGTATGTAATGACGTTGTTTTACTCTTCT
GAGCCTCGATACAGTTTACTATCTGCATAC|ACTCAGACTTCGCCCCATTATTTGGTATCC
AGGTATGTAATCCATAAATCGCACAGTATG|TATGTAATTAGGTATGTAATGGAGCGCGAG
TAATGACGTTGTTTTACTCTTCTGGGTGCG|TCACGTATGTCGCGTCCGGAGACCTCCCGT
ACAGTCCATTCGCCCATGCTGGCGCCTCGG|GCAATAAACTGGAGGCCAGCCTTTAAAAGA
GTGTTTAGGTATGTAATGGATCGAGCCTCG|CTTAGGCGCCCTGTGAGGGACTACTCAGAC
GTCCTGTACTCGCATAGAGAAACATATGAT|TGTAATGGATCGAGCCTCGATACAGTTTAC
ATCGGAGTTCGTGTTTAGGTATGTAATTCA|TGTAGGTGACATAGCGAGCTCCGCATCCGG
GCGCCTTCCGAGGGTTATCACGCACAGTCC|ACCAAATTTTTACTACAATCGTTGCAATAA
CGTCCGGAGACCTCCCGTCGAAGGATGCTG|TTGCATCCGGAGTTCGTGTTTAGGTATGTA
TCACGGTTGTCCGCATTAGAGGGAGTCAGA|CAACGGGAATACGTGCGATCTATTTCATCA
GAGTTCGTGTTTGCATCCGGAGTTCGTGTT|TCAGGTCGCGTGTCCCCCCACAGGAATCAC
GTGTTTAGGTATGTAATTCACGTATGTCGC|ATAGCGAGCTCCGCATCCGGAGTTCGTGTT
GTGTTTAGGTATGTAATTAGGTATGTAATG|CTCTTCTGGGTGCGAACGCCCGTAGGTTTC
CGGAGTTCGTGTTTAGGTATGTAATGGATC|TTCTGCACCTTAGGCGCCCTGTGAGGGACT
GTTTAGGTATGTAATCGCATCCGGAGTTCG|TGTAACGCATCCGGAGTTCGTGTTTAGGTA
TAATCATAACGCCGTCAGGTCGCGTGTCCC|ATTCCTGTAATCCGTATCTGGACCGCCATG
GCAATCATGTTATTACACAAATGCAAGAGG|CGCCGCATCCGGAGTTCGTGTTTAGGTATG
ATAGGTATGTAATTGCGCCGCATCCGGAGT|ATTAGAGGGAGTCAGAGATGAAATATATCA
ATGTAATCATAACGCCGTCAGGTCGCGTGT|TGCATTCCTGTAATCCGTATCTGGACCGCC
AGGTGCTGGCCACCTAGATGTACGGACCCG|TCGTGTTTAGGTATGTAATAGCATCCGGAG
CAATCATGTTATTACACAAATGCAAGAGGC|GCCGCATCCGGAGTTCGTGTTTAGGTATGT
TGTTTAGGTATGTAATTAGGTATGTAATGG|TCTTCTGGGTGCGAACGCCCGTAGGTTTCG
GGTATGTAATAGGTATGTAATTGCGCCGCA|TTGTCCGCATTAGAGGGAGTCAGAGATGAA
GCCCCATTATTTGGTATCCCTATGGAGGCA|ATGCCCGCATCCGGAGTTCGTGTTGCATCC
GCCCGCATCCGGAGTTCGTGTTGCATCCGG|GAGTTCGTGTTTAGGTATGTAATGACGTTG
CGTTGCAATAAACTGGAGGCCAGCCTTTAA|TAGAATGAATCTGACTTGCATCCGGAGTTC
CGAAGGATGCTGTAATAGTACCCCCTGGCA|TTTAGGTATGTAATAGGTATGTAATTGCGC
GTATGTAATTCACGTATGTCGCGTCCGGAG|CTCCGCATCCGGAGTTCGTGTTTGCATCCG
TTCGTGTTTAGGTATGTAATCATAACGCCG|GGTATGTAATCCTTGCATTCCTGTAATCCG
GTGTCAGGCTTCTGCACCTTAGGCGCCCTG|AAACTAATTGATGCATCCGGAGTTCGTGTT
TGAATCTGACTTGCATCCGGAGTTCGTGTT|CGGCTTGGGTGTCAGGCTTCTGCACCTTAG
GCATCCGGAGTTCGTGTTTAGGTATGTAAT|TCCCCCCACAGGAATCACGGTTGTCCGCAT
CTTCTGGGTGCGAACGCCCGTAGGTTTCGT|GAGACCTCCCGTCGAAGGATGCTGTAATAG
TGTAATCATAACGCCGTCAGGTCGCGTGTC|GCATTCCTGTAATCCGTATCTGGACCGCCA
AGAATCGTTAGTGGCTTTAGGTAGGTGCTG|CTGGCGCCTCGGCATCCGGAGTTCGTGTTT
TATGTAATAGGTATGTAATTGCGCCGCATC|GTCCGCATTAGAGGGAGTCAGAGATGAAAT
GGAGTATCAACCCGAAAGTTTGATTAGAAT|TTCGAGTATTGGTCCACTATCACGAACAGC
TAGGTATGTAATGGAGCGCGAGTGAGGTAA|GCCCGTAGGTTTCGTAAAGTCGAGGGTAAC
CTTTAGGTAGGTGCTGGCCACCTAGATGTA|TCCGGAGTTCGTGTTTAGGTATGTAATAGC
ATCGCACAGTATGACTAAAACTAATTGATG|AATGGAGCGCGAGTGAGGTAAGATTAGCGC
TCAGGCTTCTGCACCTTAGGCGCCCTGTGA|CTAATTGATGCATCCGGAGTTCGTGTTTAG
GTCAGGCTTCTGCACCTTAGGCGCCCTGTG|ACTAATTGATGCATCCGGAGTTCGTGTTTA
GAGGCCAGCCTTTAAAAGAGGGGTAAGTCC|TTGCATCCGGAGTTCGTGTTTAGGTATGTA
TTAGGTATGTAATCGCATCCGGAGTTCGTG|TAACGCATCCGGAGTTCGTGTTTAGGTATG
AGGTGACATAGCGAGCTCCGCATCCGGAGT|TGTTTAGGTATGTAATCATAACGCCGTCAG
TTCGTGTTTAGGTATGTAATCCATAAATCG|GTGTTTAGGTATGTAATTAGGTATGTAATG
TGACTAAAACTAATTGATGCATCCGGAGTT|AGTGAGGTAAGATTAGCGCTTTGACCGTTG
GGAGCGCGAGTGAGGTAAGATTAGCGCTTT|CGTAAAGTCGAGGGTAACCTCCTAGGCATC
CCCCCTGGCAATCATGTTATTACACAAATG|GTAATTGCGCCGCATCCGGAGTTCGTGTTT
ATGGACTAGAATAACCAGTGTGGCAGATAT|CTGCATACCCAATTATTCGGTACTCGTGCA
TGTAATCGCATCCGGAGTTCGTGTTTAGGT|TCCGGAGTTCGTGTTTAGGTATGTAATCCT
GGTATGTAATCGGAGTTCGTGTTTAGGTAT|GGCGAGGATGTAGGTGACATAGCGAGCTCC
CCCATGCTGGCGCCTCGGCATCCGGAGTTC|AGGCCAGCCTTTAAAAGAGGGGTAAGTCCT
TCGTGTTTAGGTATGTAATAGGTATGTAAT|GAATCACGGTTGTCCGCATTAGAGGGAGTC
AGAATAACCAGTGTGGCAGATATGTGGAGT|CCCAATTATTCGGTACTCGTGCAATTTCGA
TCAGACTTCGCCCCATTATTTGGTATCCCT|TAATCTACGATGCCCGCATCCGGAGTTCGT
AGCGAGCTCCGCATCCGGAGTTCGTGTTTG|ATGTAATCATAACGCCGTCAGGTCGCGTGT
TGTTTAGGTATGTAATGGATCGAGCCTCGA|TTAGGCGCCCTGTGAGGGACTACTCAGACT
CTCCGCATCCGGAGTTCGTGTTTGCATCCG|TCATAACGCCGTCAGGTCGCGTGTCCCCCC
GCCTCGGCATCCGGAGTTCGTGTTTAGGTA|TAAAAGAGGGGTAAGTCCTGTACTCGCATA
AGTTTACTATCTGCATACCCAATTATTCGG|CCCCATTATTTGGTATCCCTATGGAGGCAT
GTAATGGATCGAGCCTCGATACAGTTTACT|GTGAGGGACTACTCAGACTTCGCCCCATTA
TTTAGGTATGTAATAGCATCCGGAGTTCGT|CTCGCATAGAGAAACATATGATCCCATGGA
TGTTTAGGTATGTAATCGCATCCGGAGTTC|ATGTAACGCATCCGGAGTTCGTGTTTAGGT
TCTTCTGGGTGCGAACGCCCGTAGGTTTCG|GGAGACCTCCCGTCGAAGGATGCTGTAATA
GGAGTTCGTGTTTAGGTATGTAATCATAAC|TTTAGGTATGTAATCCTTGCATTCCTGTAA
CCTAGATGTACGGACCCGTCTCGGGGATCC|ATGTAATAGCATCCGGAGTTCGTGTTTAGG
TCGAGGGTAACCTCCTAGGCATCGCATCCG|CCCTGGCAATCATGTTATTACACAAATGCA
TGTTTAGGTATGTAATGACGTTGTTTTACT|TAGGTATGTAATTCACGTATGTCGCGTCCG
GTAATGACGTTGTTTTACTCTTCTGGGTGC|TTCACGTATGTCGCGTCCGGAGACCTCCCG
TCCCCACTTGGGTCAATCCGGCGGGTCTGC|AGGTATGTAATTGCAGTTAGGTGAAGCTAC
TCGACTTTGGTCCGAGAATCGTTAGTGGCT|TCCATTCGCCCATGCTGGCGCCTCGGCATC
TCCGGAGTTCGTGTTTAGGTATGTAATAGG|CCCCACAGGAATCACGGTTGTCCGCATTAG
TTAATCGACTTTGGTCCGAGAATCGTTAGT|ACAGTCCATTCGCCCATGCTGGCGCCTCGG
CGTCAGGTCGCGTGTCCCCCCACAGGAATC|CGTATCTGGACCGCCATGTTAGGCCTTACA
GGTATGTAATGGATCGAGCCTCGATACAGT|GCCCTGTGAGGGACTACTCAGACTTCGCCC
TAACCTCCTAGGCATCGCATCCGGAGTTCG|AATCATGTTATTACACAAATGCAAGAGGCA
GTAAGTCCTGTACTCGCATAGAGAAACATA|GGTATGTAATGGATCGAGCCTCGATACAGT
CATGTTATTACACAAATGCAAGAGGCATAA|CATCCGGAGTTCGTGTTTAGGTATGTAATC
TCCGAGGGTTATCACGCACAGTCCATTCGC|TTTTTACTACAATCGTTGCAATAAACTGGA
CCGTTGCTGTGCGGTAGAGAGGCCCGGGCA|ATCCGGAGTTCGTGTTTAGGTATGTAATCG
TGTTTGCATCCGGAGTTCGTGTTTAGGTAT|GCGTGTCCCCCCACAGGAATCACGGTTGTC
AGGCTTCTGCACCTTAGGCGCCCTGTGAGG|AATTGATGCATCCGGAGTTCGTGTTTAGGT
CATACCCAATTATTCGGTACTCGTGCAATT|TATCCCTATGGAGGCATCCGGAGTTCGTGT
AATTGCAGTTAGGTGAAGCTACCAAATTTT|GTGTGGCAGATATGTGGAGTATCAACCCGA
TTTAGGTATGTAATTGCAGTTAGGTGAAGC|TAGAATAACCAGTGTGGCAGATATGTGGAG
ATGTAATGGAGCGCGAGTGAGGTAAGATTA|TAGGTTTCGTAAAGTCGAGGGTAACCTCCT
CCTTAGGCGCCCTGTGAGGGACTACTCAGA|CCGGAGTTCGTGTTTAGGTATGTAATAATC
CACAGTATGACTAAAACTAATTGATGCATC|GAGCGCGAGTGAGGTAAGATTAGCGCTTTG
ATCCGGAGTTCGTGTTGCATCCGGAGTTCG|GTGTTTAGGTATGTAATGACGTTGTTTTAC
GGGTGCGAACGCCCGTAGGTTTCGTAAAGT|CTCCCGTCGAAGGATGCTGTAATAGTACCC
ACTCTTCTGGGTGCGAACGCCCGTAGGTTT|CCGGAGACCTCCCGTCGAAGGATGCTGTAA
CTACCAAATTTTTACTACAATCGTTGCAAT|GTATCAACCCGAAAGTTTGATTAGAATGAA
CAGTATGACTAAAACTAATTGATGCATCCG|GCGCGAGTGAGGTAAGATTAGCGCTTTGAC
CAAGAGGCATAACCAGGCGAGGATGTAGGT|AGGTATGTAATCGCATCCGGAGTTCGTGTT
TGTAATTAGGTATGTAATGGAGCGCGAGTG|GCGAACGCCCGTAGGTTTCGTAAAGTCGAG
TTCGTGTTTAGGTATGTAATAGGTATGTAA|GGAATCACGGTTGTCCGCATTAGAGGGAGT
GTTCGTGTTTAGGTATGTAATTCACGTATG|TGACATAGCGAGCTCCGCATCCGGAGTTCG
AGTCCTGTACTCGCATAGAGAAACATATGA|ATGTAATGGATCGAGCCTCGATACAGTTTA
CCTCGGCATCCGGAGTTCGTGTTTAGGTAT|AAAAGAGGGGTAAGTCCTGTACTCGCATAG
TGGTATCCCTATGGAGGCATCCGGAGTTCG|CGGAGTTCGTGTTGCATCCGGAGTTCGTGT
TTAGGTATGTAATCATAACGCCGTCAGGTC|AATCCTTGCATTCCTGTAATCCGTATCTGG
AAAGTCGAGGGTAACCTCCTAGGCATCGCA|TACCCCCTGGCAATCATGTTATTACACAAA
CGCATCCGGAGTTCGTGTTTAGGTATGTAA|CAAATGCAAGAGGCATAACCAGGCGAGGAT
AGGTATGTAATGGAGCGCGAGTGAGGTAAG|CCCGTAGGTTTCGTAAAGTCGAGGGTAACC
ATGGAGGCATCCGGAGTTCGTGTTTAGGTA|GTTGCATCCGGAGTTCGTGTTTAGGTATGT
TCCGGAGTTCGTGTTTAGGTATGTAATTAG|CGTTGTTTTACTCTTCTGGGTGCGAACGCC
TTACACAAATGCAAGAGGCATAACCAGGCG|AGTTCGTGTTTAGGTATGTAATCGCATCCG
ATGGATCGAGCCTCGATACAGTTTACTATC|AGGGACTACTCAGACTTCGCCCCATTATTT
TTCGAGTATTGGTCCACTATCACGAACAGC|TTTAGGTATGTAATCCATAAATCGCACAGT
CGGCTTGGGTGTCAGGCTTCTGCACCTTAG|TATGACTAAAACTAATTGATGCATCCGGAG
GGCATCCGGAGTTCGTGTTTAGGTATGTAA|GAGGGGTAAGTCCTGTACTCGCATAGAGAA
TATGTAATGACGTTGTTTTACTCTTCTGGG|TAATTCACGTATGTCGCGTCCGGAGACCTC
TCCGGAGTTCGTGTTTAGGTATGTAATCGC|ATATATCACCAATGTAACGCATCCGGAGTT
GGAGTTCGTGTTTAGGTATGTAATAATCTA|CCGTTGCTGTGCGGTAGAGAGGCCCGGGCA
GGCGGGTCTGCGCCTTCCGAGGGTTATCAC|GGTGAAGCTACCAAATTTTTACTACAATCG
CATAACGCCGTCAGGTCGCGTGTCCCCCCA|CTGTAATCCGTATCTGGACCGCCATGTTAG
AGGCATAACCAGGCGAGGATGTAGGTGACA|ATGTAATCGCATCCGGAGTTCGTGTTTAGG
TTTAGGTATGTAATTAGGTATGTAATGGAG|TTCTGGGTGCGAACGCCCGTAGGTTTCGTA
TCGGGGATCCCCACTTGGGTCAATCCGGCG|CGTGTTTAGGTATGTAATTGCAGTTAGGTG
ATCCGGCGGGTCTGCGCCTTCCGAGGGTTA|GTTAGGTGAAGCTACCAAATTTTTACTACA
CGACTTTGGTCCGAGAATCGTTAGTGGCTT|CCATTCGCCCATGCTGGCGCCTCGGCATCC
ATCCGGAGTTCGTGTTTAGGTATGTAATAG|CCCCCACAGGAATCACGGTTGTCCGCATTA
GGAGTTCGTGTTTAGGTATGTAATTCACGT|AGGTGACATAGCGAGCTCCGCATCCGGAGT
GTTTAGGTATGTAATTCACGTATGTCGCGT|AGCGAGCTCCGCATCCGGAGTTCGTGTTTG
GTTAGTGGCTTTAGGTAGGTGCTGGCCACC|CCTCGGCATCCGGAGTTCGTGTTTAGGTAT
AGTTCGTGTTTAGGTATGTAATAGCATCCG|GTCCTGTACTCGCATAGAGAAACATATGAT
AGATATGTGGAGTATCAACCCGAAAGTTTG|CGTGCAATTTCGAGTATTGGTCCACTATCA
TAGTGGCTTTAGGTAGGTGCTGGCCACCTA|TCGGCATCCGGAGTTCGTGTTTAGGTATGT
GGTGACATAGCGAGCTCCGCATCCGGAGTT|GTTTAGGTATGTAATCATAACGCCGTCAGG
TGTTTAGGTATGTAATTGCAGTTAGGTGAA|ACTAGAATAACCAGTGTGGCAGATATGTGG
TAGGTATGTAATTGCAGTTAGGTGAAGCTA|GAATAACCAGTGTGGCAGATATGTGGAGTA
GTAATCGCATCCGGAGTTCGTGTTTAGGTA|CCGGAGTTCGTGTTTAGGTATGTAATCCTT
GGCTTGGGTGTCAGGCTTCTGCACCTTAGG|ATGACTAAAACTAATTGATGCATCCGGAGT
GCATCGCATCCGGAGTTCGTGTTTAGGTAT|TACACAAATGCAAGAGGCATAACCAGGCGA
GGCAGATATGTGGAGTATCAACCCGAAAGT|ACTCGTGCAATTTCGAGTATTGGTCCACTA
AACCAGTGTGGCAGATATGTGGAGTATCAA|TTATTCGGTACTCGTGCAATTTCGAGTATT
TTGCAGTTAGGTGAAGCTACCAAATTTTTA|GTGGCAGATATGTGGAGTATCAACCCGAAA
GCGCCGCATCCGGAGTTCGTGTTTAGGTAT|GAGATGAAATATATCACCAATGTAACGCAT
TGGACTAGAATAACCAGTGTGGCAGATATG|TGCATACCCAATTATTCGGTACTCGTGCAA
ATGTAATTCACGTATGTCGCGTCCGGAGAC|CCGCATCCGGAGTTCGTGTTTGCATCCGGA
CTAGGCATCGCATCCGGAGTTCGTGTTTAG|TTATTACACAAATGCAAGAGGCATAACCAG
CCGGAGTTCGTGTTTAGGTATGTAATCGGA|GCAAGAGGCATAACCAGGCGAGGATGTAGG
GTTAGGTGAAGCTACCAAATTTTTACTACA|AGATATGTGGAGTATCAACCCGAAAGTTTG
CCGTCTCGGGGATCCCCACTTGGGTCAATC|GAGTTCGTGTTTAGGTATGTAATTGCAGTT
AGTTCGTGTTTAGGTATGTAATCATAACGC|TAGGTATGTAATCCTTGCATTCCTGTAATC
GTAATTGCGCCGCATCCGGAGTTCGTGTTT|GAGTCAGAGATGAAATATATCACCAATGTA
CGCGTCCGGAGACCTCCCGTCGAAGGATGC|GTTTGCATCCGGAGTTCGTGTTTAGGTATG
CCATGCTGGCGCCTCGGCATCCGGAGTTCG|GGCCAGCCTTTAAAAGAGGGGTAAGTCCTG
TGCATCCGGAGTTCGTGTTTAGGTATGTAA|GCTTTGACCGTTGCTGTGCGGTAGAGAGGC
CCTCCCGTCGAAGGATGCTGTAATAGTACC|AGTTCGTGTTTAGGTATGTAATAGGTATGT
GCACAGTCCATTCGCCCATGCTGGCGCCTC|TTGCAATAAACTGGAGGCCAGCCTTTAAAA
AGTTCGTGTTTAGGTATGTAATAGGTATGT|CAGGAATCACGGTTGTCCGCATTAGAGGGA
GTCCGGAGACCTCCCGTCGAAGGATGCTGT|TGCATCCGGAGTTCGTGTTTAGGTATGTAA
TTTAGGTATGTAATAATCTACGATGCCCGC|GCGGTAGAGAGGCCCGGGCATCCGGAGTTC
GCATCCGGAGTTCGTGTTGCATCCGGAGTT|TCGTGTTTAGGTATGTAATGACGTTGTTTT
AAACTAATTGATGCATCCGGAGTTCGTGTT|GTAAGATTAGCGCTTTGACCGTTGCTGTGC
GTGTTTAGGTATGTAATCCATAAATCGCAC|TTTAGGTATGTAATTAGGTATGTAATGGAG
AATCGCACAGTATGACTAAAACTAATTGAT|TAATGGAGCGCGAGTGAGGTAAGATTAGCG
TCGTGTTTGCATCCGGAGTTCGTGTTTAGG|GTCGCGTGTCCCCCCACAGGAATCACGGTT
TGCAGTTAGGTGAAGCTACCAAATTTTTAC|TGGCAGATATGTGGAGTATCAACCCGAAAG
TCCATTCGCCCATGCTGGCGCCTCGGCATC|TAAACTGGAGGCCAGCCTTTAAAAGAGGGG
CGGAGTTCGTGTTTAGGTATGTAATCGGAG|CAAGAGGCATAACCAGGCGAGGATGTAGGT
CGTGCAATTTCGAGTATTGGTCCACTATCA|AGTTCGTGTTTAGGTATGTAATCCATAAAT
AAATTTTTACTACAATCGTTGCAATAAACT|AACCCGAAAGTTTGATTAGAATGAATCTGA
CAGGCGAGGATGTAGGTGACATAGCGAGCT|CATCCGGAGTTCGTGTTTAGGTATGTAATC
GAAACATATGATCCCATGGACTAGAATAAC|GATACAGTTTACTATCTGCATACCCAATTA
AGACCTCCCGTCGAAGGATGCTGTAATAGT|CGGAGTTCGTGTTTAGGTATGTAATAGGTA
TAGATGTACGGACCCGTCTCGGGGATCCCC|GTAATAGCATCCGGAGTTCGTGTTTAGGTA
TCACGCACAGTCCATTCGCCCATGCTGGCG|ATCGTTGCAATAAACTGGAGGCCAGCCTTT
GAGTTCGTGTTTAGGTATGTAATCGCATCC|ATCACCAATGTAACGCATCCGGAGTTCGTG
GCTACCAAATTTTTACTACAATCGTTGCAA|AGTATCAACCCGAAAGTTTGATTAGAATGA
ACGCCGTCAGGTCGCGTGTCCCCCCACAGG|AATCCGTATCTGGACCGCCATGTTAGGCCT
CAATTATTCGGTACTCGTGCAATTTCGAGT|TATGGAGGCATCCGGAGTTCGTGTTTAGGT
CTGGCCACCTAGATGTACGGACCCGTCTCG|TTTAGGTATGTAATAGCATCCGGAGTTCGT
AGTATTGGTCCACTATCACGAACAGCGGCT|GGTATGTAATCCATAAATCGCACAGTATGA
TTAGGTATGTAATCGGAGTTCGTGTTTAGG|CCAGGCGAGGATGTAGGTGACATAGCGAGC
GTATGTAATTAGGTATGTAATGGAGCGCGA|GGTGCGAACGCCCGTAGGTTTCGTAAAGTC
TTCGTGTTTAGGTATGTAATGACGTTGTTT|TGTTTAGGTATGTAATTCACGTATGTCGCG
AGGTATGTAATTCACGTATGTCGCGTCCGG|AGCTCCGCATCCGGAGTTCGTGTTTGCATC
GCTGTGCGGTAGAGAGGCCCGGGCATCCGG|GAGTTCGTGTTTAGGTATGTAATCGGAGTT
CGGAGTTCGTGTTGCATCCGGAGTTCGTGT|TTTAGGTATGTAATGACGTTGTTTTACTCT
ACATAGCGAGCTCCGCATCCGGAGTTCGTG|AGGTATGTAATCATAACGCCGTCAGGTCGC
CAGATATGTGGAGTATCAACCCGAAAGTTT|TCGTGCAATTTCGAGTATTGGTCCACTATC
CCACAGGAATCACGGTTGTCCGCATTAGAG|TAGGCCTTACAACGGGAATACGTGCGATCT
TTCGTGTTTAGGTATGTAATTAGGTATGTA|TTACTCTTCTGGGTGCGAACGCCCGTAGGT
GGAGTTCGTGTTTAGGTATGTAATCGCATC|TATCACCAATGTAACGCATCCGGAGTTCGT
TTGCAATAAACTGGAGGCCAGCCTTTAAAA|GAATGAATCTGACTTGCATCCGGAGTTCGT
GTGGCTTTAGGTAGGTGCTGGCCACCTAGA|GGCATCCGGAGTTCGTGTTTAGGTATGTAA
GTGTCCCCCCACAGGAATCACGGTTGTCCG|CGCCATGTTAGGCCTTACAACGGGAATACG
TAATAGCATCCGGAGTTCGTGTTTAGGTAT|GAAACATATGATCCCATGGACTAGAATAAC
TTGGGTCAATCCGGCGGGTCTGCGCCTTCC|TAATTGCAGTTAGGTGAAGCTACCAAATTT
TATGTAATGGATCGAGCCTCGATACAGTTT|CCTGTGAGGGACTACTCAGACTTCGCCCCA
TACACAAATGCAAGAGGCATAACCAGGCGA|GTTCGTGTTTAGGTATGTAATCGCATCCGG
AGAATGAATCTGACTTGCATCCGGAGTTCG|ACAGCGGCTTGGGTGTCAGGCTTCTGCACC
TATGTAATCCATAAATCGCACAGTATGACT|GTAATTAGGTATGTAATGGAGCGCGAGTGA
CATCCGGAGTTCGTGTTTAGGTATGTAATT|GACGTTGTTTTACTCTTCTGGGTGCGAACG
GTGGAGTATCAACCCGAAAGTTTGATTAGA|ATTTCGAGTATTGGTCCACTATCACGAACA
ACCAGTGTGGCAGATATGTGGAGTATCAAC|TATTCGGTACTCGTGCAATTTCGAGTATTG
GCGAGGATGTAGGTGACATAGCGAGCTCCG|CCGGAGTTCGTGTTTAGGTATGTAATCATA
AGATGTACGGACCCGTCTCGGGGATCCCCA|TAATAGCATCCGGAGTTCGTGTTTAGGTAT
CACAAATGCAAGAGGCATAACCAGGCGAGG|TCGTGTTTAGGTATGTAATCGCATCCGGAG
CCCACTTGGGTCAATCCGGCGGGTCTGCGC|GTATGTAATTGCAGTTAGGTGAAGCTACCA
GTAATAGGTATGTAATTGCGCCGCATCCGG|CGCATTAGAGGGAGTCAGAGATGAAATATA
CCCCACTTGGGTCAATCCGGCGGGTCTGCG|GGTATGTAATTGCAGTTAGGTGAAGCTACC
GCCGCATCCGGAGTTCGTGTTTAGGTATGT|GATGAAATATATCACCAATGTAACGCATCC
CCGGAGTTCGTGTTTAGGTATGTAATCATA|TGTTTAGGTATGTAATCCTTGCATTCCTGT
CGTTAGTGGCTTTAGGTAGGTGCTGGCCAC|GCCTCGGCATCCGGAGTTCGTGTTTAGGTA
GTTTAGGTATGTAATCATAACGCCGTCAGG|GTAATCCTTGCATTCCTGTAATCCGTATCT
CTAGAATAACCAGTGTGGCAGATATGTGGA|TACCCAATTATTCGGTACTCGTGCAATTTC
TTAGGTATGTAATGGAGCGCGAGTGAGGTA|CGCCCGTAGGTTTCGTAAAGTCGAGGGTAA
CTAAAACTAATTGATGCATCCGGAGTTCGT|GAGGTAAGATTAGCGCTTTGACCGTTGCTG
ATCCGGAGTTCGTGTTTAGGTATGTAATGA|GGAGTTCGTGTTTAGGTATGTAATTCACGT
GGAGTTCGTGTTTAGGTATGTAATGACGTT|TTCGTGTTTAGGTATGTAATTCACGTATGT
CGAGGGTTATCACGCACAGTCCATTCGCCC|TTTACTACAATCGTTGCAATAAACTGGAGG
TATTTGGTATCCCTATGGAGGCATCCGGAG|CATCCGGAGTTCGTGTTGCATCCGGAGTTC
TCCGGAGTTCGTGTTTAGGTATGTAATCGG|TGCAAGAGGCATAACCAGGCGAGGATGTAG
TTACTATCTGCATACCCAATTATTCGGTAC|CATTATTTGGTATCCCTATGGAGGCATCCG
CAGTTTACTATCTGCATACCCAATTATTCG|GCCCCATTATTTGGTATCCCTATGGAGGCA
CCCGTCTCGGGGATCCCCACTTGGGTCAAT|GGAGTTCGTGTTTAGGTATGTAATTGCAGT
CTTGGGTCAATCCGGCGGGTCTGCGCCTTC|GTAATTGCAGTTAGGTGAAGCTACCAAATT
CATCCGGAGTTCGTGTTTAGGTATGTAATC|AAATATATCACCAATGTAACGCATCCGGAG
ATATGATCCCATGGACTAGAATAACCAGTG|AGTTTACTATCTGCATACCCAATTATTCGG
GTCCGAGAATCGTTAGTGGCTTTAGGTAGG|CCATGCTGGCGCCTCGGCATCCGGAGTTCG
AATAGCATCCGGAGTTCGTGTTTAGGTATG|AAACATATGATCCCATGGACTAGAATAACC
AGTTCGTGTTTGCATCCGGAGTTCGTGTTT|CAGGTCGCGTGTCCCCCCACAGGAATCACG
TCGGTACTCGTGCAATTTCGAGTATTGGTC|GCATCCGGAGTTCGTGTTTAGGTATGTAAT
AGGTATGTAATCGCATCCGGAGTTCGTGTT|ACGCATCCGGAGTTCGTGTTTAGGTATGTA
TTAGGTATGTAATTGCAGTTAGGTGAAGCT|AGAATAACCAGTGTGGCAGATATGTGGAGT
TGTAATAGGTATGTAATTGCGCCGCATCCG|CCGCATTAGAGGGAGTCAGAGATGAAATAT
GTAATGGAGCGCGAGTGAGGTAAGATTAGC|GGTTTCGTAAAGTCGAGGGTAACCTCCTAG
GGTGCGAACGCCCGTAGGTTTCGTAAAGTC|TCCCGTCGAAGGATGCTGTAATAGTACCCC
CGGGGATCCCCACTTGGGTCAATCCGGCGG|GTGTTTAGGTATGTAATTGCAGTTAGGTGA
CCGGAGTTCGTGTTTAGGTATGTAATCGCA|TATATCACCAATGTAACGCATCCGGAGTTC
TTCACGTATGTCGCGTCCGGAGACCTCCCG|CCGGAGTTCGTGTTTGCATCCGGAGTTCGT
TCTGGGTGCGAACGCCCGTAGGTTTCGTAA|GACCTCCCGTCGAAGGATGCTGTAATAGTA
AGTACCCCCTGGCAATCATGTTATTACACA|GTATGTAATTGCGCCGCATCCGGAGTTCGT
CACAGTCCATTCGCCCATGCTGGCGCCTCG|TGCAATAAACTGGAGGCCAGCCTTTAAAAG
TTCGTGTTTAGGTATGTAATGGATCGAGCC|CACCTTAGGCGCCCTGTGAGGGACTACTCA
CATATGATCCCATGGACTAGAATAACCAGT|CAGTTTACTATCTGCATACCCAATTATTCG
GTAATAATCTACGATGCCCGCATCCGGAGT|AGGCCCGGGCATCCGGAGTTCGTGTTTAGG
TGATTAGAATGAATCTGACTTGCATCCGGA|CACGAACAGCGGCTTGGGTGTCAGGCTTCT
TTCTGGGTGCGAACGCCCGTAGGTTTCGTA|AGACCTCCCGTCGAAGGATGCTGTAATAGT
CAGCGGCTTGGGTGTCAGGCTTCTGCACCT|CAGTATGACTAAAACTAATTGATGCATCCG
TAGGTGCTGGCCACCTAGATGTACGGACCC|TTCGTGTTTAGGTATGTAATAGCATCCGGA
CGCATCCGGAGTTCGTGTTTAGGTATGTAA|GTTCGTGTTTAGGTATGTAATCCTTGCATT
CCAGGCGAGGATGTAGGTGACATAGCGAGC|GCATCCGGAGTTCGTGTTTAGGTATGTAAT
GTTTCGTAAAGTCGAGGGTAACCTCCTAGG|GTAATAGTACCCCCTGGCAATCATGTTATT
GTTTAGGTATGTAATAATCTACGATGCCCG|TGCGGTAGAGAGGCCCGGGCATCCGGAGTT
ACTTTGGTCCGAGAATCGTTAGTGGCTTTA|ATTCGCCCATGCTGGCGCCTCGGCATCCGG
TAGGTTTCGTAAAGTCGAGGGTAACCTCCT|GCTGTAATAGTACCCCCTGGCAATCATGTT
GCTGGCCACCTAGATGTACGGACCCGTCTC|GTTTAGGTATGTAATAGCATCCGGAGTTCG
AATCGTTAGTGGCTTTAGGTAGGTGCTGGC|GGCGCCTCGGCATCCGGAGTTCGTGTTTAG
CGCATAGAGAAACATATGATCCCATGGACT|CGAGCCTCGATACAGTTTACTATCTGCATA
GAGAGGCCCGGGCATCCGGAGTTCGTGTTT|TAGGTATGTAATCGGAGTTCGTGTTTAGGT
GGTATGTAATAGCATCCGGAGTTCGTGTTT|CATAGAGAAACATATGATCCCATGGACTAG
TGTGAGGGACTACTCAGACTTCGCCCCATT|TTTAGGTATGTAATAATCTACGATGCCCGC
TCATGTTATTACACAAATGCAAGAGGCATA|GCATCCGGAGTTCGTGTTTAGGTATGTAAT
ATCGTTGCAATAAACTGGAGGCCAGCCTTT|ATTAGAATGAATCTGACTTGCATCCGGAGT
ATTCGGTACTCGTGCAATTTCGAGTATTGG|AGGCATCCGGAGTTCGTGTTTAGGTATGTA
GAATCACGGTTGTCCGCATTAGAGGGAGTC|TTACAACGGGAATACGTGCGATCTATTTCA
CCAGCCTTTAAAAGAGGGGTAAGTCCTGTA|ATCCGGAGTTCGTGTTTAGGTATGTAATGG
CGGAGTTCGTGTTTAGGTATGTAATTAGGT|TTGTTTTACTCTTCTGGGTGCGAACGCCCG
CTATCACGAACAGCGGCTTGGGTGTCAGGC|ATAAATCGCACAGTATGACTAAAACTAATT
GTTGCTGTGCGGTAGAGAGGCCCGGGCATC|CCGGAGTTCGTGTTTAGGTATGTAATCGGA
CCTCGATACAGTTTACTATCTGCATACCCA|CAGACTTCGCCCCATTATTTGGTATCCCTA
CTGTGAGGGACTACTCAGACTTCGCCCCAT|GTTTAGGTATGTAATAATCTACGATGCCCG
GACTAGAATAACCAGTGTGGCAGATATGTG|CATACCCAATTATTCGGTACTCGTGCAATT
ATCGAGCCTCGATACAGTTTACTATCTGCA|ACTACTCAGACTTCGCCCCATTATTTGGTA
TAATCCATAAATCGCACAGTATGACTAAAA|TTAGGTATGTAATGGAGCGCGAGTGAGGTA
GTGTTTAGGTATGTAATAGGTATGTAATTG|ATCACGGTTGTCCGCATTAGAGGGAGTCAG
ATCCGGAGTTCGTGTTTAGGTATGTAATCA|CGTGTTTAGGTATGTAATCCTTGCATTCCT
TTAGGCGCCCTGTGAGGGACTACTCAGACT|GGAGTTCGTGTTTAGGTATGTAATAATCTA
GTTCGTGTTTGCATCCGGAGTTCGTGTTTA|AGGTCGCGTGTCCCCCCACAGGAATCACGG
TCGCATCCGGAGTTCGTGTTTAGGTATGTA|AGTTCGTGTTTAGGTATGTAATCCTTGCAT
TTTAGGTATGTAATGACGTTGTTTTACTCT|GGTATGTAATTCACGTATGTCGCGTCCGGA
CACTATCACGAACAGCGGCTTGGGTGTCAG|CCATAAATCGCACAGTATGACTAAAACTAA
GTGAGGTAAGATTAGCGCTTTGACCGTTGC|GAGGGTAACCTCCTAGGCATCGCATCCGGA
TCCATAAATCGCACAGTATGACTAAAACTA|GGTATGTAATGGAGCGCGAGTGAGGTAAGA
TCGAAGGATGCTGTAATAGTACCCCCTGGC|GTTTAGGTATGTAATAGGTATGTAATTGCG
GGAGTTCGTGTTTGCATCCGGAGTTCGTGT|GTCAGGTCGCGTGTCCCCCCACAGGAATCA
GCCTCGATACAGTTTACTATCTGCATACCC|TCAGACTTCGCCCCATTATTTGGTATCCCT
ACTTGGGTCAATCCGGCGGGTCTGCGCCTT|TGTAATTGCAGTTAGGTGAAGCTACCAAAT
AGAGAAACATATGATCCCATGGACTAGAAT|CTCGATACAGTTTACTATCTGCATACCCAA
CGAAAGTTTGATTAGAATGAATCTGACTTG|TCCACTATCACGAACAGCGGCTTGGGTGTC
CCGGAGTTCGTGTTTAGGTATGTAATTGCA|GATCCCATGGACTAGAATAACCAGTGTGGC
GGTGTCAGGCTTCTGCACCTTAGGCGCCCT|AAAACTAATTGATGCATCCGGAGTTCGTGT
TAACGCCGTCAGGTCGCGTGTCCCCCCACA|GTAATCCGTATCTGGACCGCCATGTTAGGC
ACTTCGCCCCATTATTTGGTATCCCTATGG|CTACGATGCCCGCATCCGGAGTTCGTGTTG
TTGCATCCGGAGTTCGTGTTTAGGTATGTA|TGTCCCCCCACAGGAATCACGGTTGTCCGC
CTTCGCCCCATTATTTGGTATCCCTATGGA|TACGATGCCCGCATCCGGAGTTCGTGTTGC
TTCGTGTTTAGGTATGTAATTCACGTATGT|GACATAGCGAGCTCCGCATCCGGAGTTCGT
TAGCGAGCTCCGCATCCGGAGTTCGTGTTT|TATGTAATCATAACGCCGTCAGGTCGCGTG
GGTATGTAATTGCGCCGCATCCGGAGTTCG|AGAGGGAGTCAGAGATGAAATATATCACCA
ACCGTTGCTGTGCGGTAGAGAGGCCCGGGC|CATCCGGAGTTCGTGTTTAGGTATGTAATC
CGTGTTTAGGTATGTAATTAGGTATGTAAT|ACTCTTCTGGGTGCGAACGCCCGTAGGTTT
CACCTAGATGTACGGACCCGTCTCGGGGAT|GTATGTAATAGCATCCGGAGTTCGTGTTTA
ACAGTATGACTAAAACTAATTGATGCATCC|AGCGCGAGTGAGGTAAGATTAGCGCTTTGA
ATAACCAGGCGAGGATGTAGGTGACATAGC|AATCGCATCCGGAGTTCGTGTTTAGGTATG
CTCAGACTTCGCCCCATTATTTGGTATCCC|ATAATCTACGATGCCCGCATCCGGAGTTCG
AGTTCGTGTTTAGGTATGTAATGGATCGAG|TGCACCTTAGGCGCCCTGTGAGGGACTACT
CACGGTTGTCCGCATTAGAGGGAGTCAGAG|AACGGGAATACGTGCGATCTATTTCATCAC
AGTTCGTGTTTAGGTATGTAATTCACGTAT|GTGACATAGCGAGCTCCGCATCCGGAGTTC
GGTATGTAATAATCTACGATGCCCGCATCC|TAGAGAGGCCCGGGCATCCGGAGTTCGTGT
TGCATCCGGAGTTCGTGTTTAGGTATGTAA|TCAGGCTTCTGCACCTTAGGCGCCCTGTGA
TAGGTATGTAATGGATCGAGCCTCGATACA|GCGCCCTGTGAGGGACTACTCAGACTTCGC
GCTTGGGTGTCAGGCTTCTGCACCTTAGGC|TGACTAAAACTAATTGATGCATCCGGAGTT
AATCTGACTTGCATCCGGAGTTCGTGTTTA|GCTTGGGTGTCAGGCTTCTGCACCTTAGGC
CCGAGGGTTATCACGCACAGTCCATTCGCC|TTTTACTACAATCGTTGCAATAAACTGGAG
TAGGTATGTAATCCATAAATCGCACAGTAT|GTATGTAATTAGGTATGTAATGGAGCGCGA
GAGTTCGTGTTGCATCCGGAGTTCGTGTTT|TAGGTATGTAATGACGTTGTTTTACTCTTC
TCCGGAGTTCGTGTTTGCATCCGGAGTTCG|GCCGTCAGGTCGCGTGTCCCCCCACAGGAA
GGCTTCTGCACCTTAGGCGCCCTGTGAGGG|ATTGATGCATCCGGAGTTCGTGTTTAGGTA
ATTAGAATGAATCTGACTTGCATCCGGAGT|CGAACAGCGGCTTGGGTGTCAGGCTTCTGC
ACGAACAGCGGCTTGGGTGTCAGGCTTCTG|TCGCACAGTATGACTAAAACTAATTGATGC
CATCCGGAGTTCGTGTTTAGGTATGTAATC|AATGCAAGAGGCATAACCAGGCGAGGATGT
TAGGTGAAGCTACCAAATTTTTACTACAAT|ATATGTGGAGTATCAACCCGAAAGTTTGAT
TGCGGTAGAGAGGCCCGGGCATCCGGAGTT|TCGTGTTTAGGTATGTAATCGGAGTTCGTG
TACCCAATTATTCGGTACTCGTGCAATTTC|TCCCTATGGAGGCATCCGGAGTTCGTGTTT
TAGGCATCGCATCCGGAGTTCGTGTTTAGG|TATTACACAAATGCAAGAGGCATAACCAGG
GAATCGTTAGTGGCTTTAGGTAGGTGCTGG|TGGCGCCTCGGCATCCGGAGTTCGTGTTTA
TTTGGTATCCCTATGGAGGCATCCGGAGTT|TCCGGAGTTCGTGTTGCATCCGGAGTTCGT
TCGTGTTTAGGTATGTAATGACGTTGTTTT|GTTTAGGTATGTAATTCACGTATGTCGCGT
TATTGGTCCACTATCACGAACAGCGGCTTG|TATGTAATCCATAAATCGCACAGTATGACT
GAGGCATCCGGAGTTCGTGTTTAGGTATGT|GCATCCGGAGTTCGTGTTTAGGTATGTAAT
TTTGATTAGAATGAATCTGACTTGCATCCG|ATCACGAACAGCGGCTTGGGTGTCAGGCTT
TATGTAATTAGGTATGTAATGGAGCGCGAG|GTGCGAACGCCCGTAGGTTTCGTAAAGTCG
ATTTCGAGTATTGGTCCACTATCACGAACA|TGTTTAGGTATGTAATCCATAAATCGCACA
TTTAGGTATGTAATCGGAGTTCGTGTTTAG|ACCAGGCGAGGATGTAGGTGACATAGCGAG
TCTCGGGGATCCCCACTTGGGTCAATCCGG|TTCGTGTTTAGGTATGTAATTGCAGTTAGG
GCATAGAGAAACATATGATCCCATGGACTA|GAGCCTCGATACAGTTTACTATCTGCATAC
TTTAGGTATGTAATTCACGTATGTCGCGTC|GCGAGCTCCGCATCCGGAGTTCGTGTTTGC
GGTCGCGTGTCCCCCCACAGGAATCACGGT|CTGGACCGCCATGTTAGGCCTTACAACGGG
GTTCGTGTTTAGGTATGTAATAGGTATGTA|AGGAATCACGGTTGTCCGCATTAGAGGGAG
GCTGTAATAGTACCCCCTGGCAATCATGTT|TGTAATAGGTATGTAATTGCGCCGCATCCG
TTAGGTATGTAATAATCTACGATGCCCGCA|CGGTAGAGAGGCCCGGGCATCCGGAGTTCG
GAGCTTTTAATCGACTTTGGTCCGAGAATC|TCACGCACAGTCCATTCGCCCATGCTGGCG
CTCGTGCAATTTCGAGTATTGGTCCACTAT|GGAGTTCGTGTTTAGGTATGTAATCCATAA
AGTATCAACCCGAAAGTTTGATTAGAATGA|CGAGTATTGGTCCACTATCACGAACAGCGG
CTCGGGGATCCCCACTTGGGTCAATCCGGC|TCGTGTTTAGGTATGTAATTGCAGTTAGGT
AATGCAAGAGGCATAACCAGGCGAGGATGT|GTTTAGGTATGTAATCGCATCCGGAGTTCG
ATCATGTTATTACACAAATGCAAGAGGCAT|CGCATCCGGAGTTCGTGTTTAGGTATGTAA
GGTATGTAATGACGTTGTTTTACTCTTCTG|TGTAATTCACGTATGTCGCGTCCGGAGACC
TAATAATCTACGATGCCCGCATCCGGAGTT|GGCCCGGGCATCCGGAGTTCGTGTTTAGGT
GAGTGAGGTAAGATTAGCGCTTTGACCGTT|TCGAGGGTAACCTCCTAGGCATCGCATCCG
CCCTGGCAATCATGTTATTACACAAATGCA|AATTGCGCCGCATCCGGAGTTCGTGTTTAG
TAAGTCCTGTACTCGCATAGAGAAACATAT|GTATGTAATGGATCGAGCCTCGATACAGTT
GGATCCCCACTTGGGTCAATCCGGCGGGTC|TTTAGGTATGTAATTGCAGTTAGGTGAAGC
GTGTTTAGGTATGTAATAATCTACGATGCC|TGTGCGGTAGAGAGGCCCGGGCATCCGGAG
GTAATTCACGTATGTCGCGTCCGGAGACCT|GCATCCGGAGTTCGTGTTTGCATCCGGAGT
GTTGTTTTACTCTTCTGGGTGCGAACGCCC|TGTCGCGTCCGGAGACCTCCCGTCGAAGGA
GCATACCCAATTATTCGGTACTCGTGCAAT|GTATCCCTATGGAGGCATCCGGAGTTCGTG
CATGGACTAGAATAACCAGTGTGGCAGATA|TCTGCATACCCAATTATTCGGTACTCGTGC
TGCAATTTCGAGTATTGGTCCACTATCACG|TTCGTGTTTAGGTATGTAATCCATAAATCG
GGTCTGCGCCTTCCGAGGGTTATCACGCAC|AAGCTACCAAATTTTTACTACAATCGTTGC
GTAGGTTTCGTAAAGTCGAGGGTAACCTCC|TGCTGTAATAGTACCCCCTGGCAATCATGT
ATTGGTCCACTATCACGAACAGCGGCTTGG|ATGTAATCCATAAATCGCACAGTATGACTA
GGGTGTCAGGCTTCTGCACCTTAGGCGCCC|TAAAACTAATTGATGCATCCGGAGTTCGTG
ACCTTAGGCGCCCTGTGAGGGACTACTCAG|TCCGGAGTTCGTGTTTAGGTATGTAATAAT
TAATTAGGTATGTAATGGAGCGCGAGTGAG|GAACGCCCGTAGGTTTCGTAAAGTCGAGGG
ATCCATAAATCGCACAGTATGACTAAAACT|AGGTATGTAATGGAGCGCGAGTGAGGTAAG
ACGGTTGTCCGCATTAGAGGGAGTCAGAGA|ACGGGAATACGTGCGATCTATTTCATCACC
CGTGTTTAGGTATGTAATAGCATCCGGAGT|TGTACTCGCATAGAGAAACATATGATCCCA
CCGCATCCGGAGTTCGTGTTTGCATCCGGA|ATAACGCCGTCAGGTCGCGTGTCCCCCCAC
TCTGCATACCCAATTATTCGGTACTCGTGC|TTGGTATCCCTATGGAGGCATCCGGAGTTC
TCACGTATGTCGCGTCCGGAGACCTCCCGT|CGGAGTTCGTGTTTGCATCCGGAGTTCGTG
TGGTCCGAGAATCGTTAGTGGCTTTAGGTA|GCCCATGCTGGCGCCTCGGCATCCGGAGTT
GAGTTCGTGTTTAGGTATGTAATTGCAGTT|CCCATGGACTAGAATAACCAGTGTGGCAGA
TTTAGGTAGGTGCTGGCCACCTAGATGTAC|CCGGAGTTCGTGTTTAGGTATGTAATAGCA
GCATCCGGAGTTCGTGTTTAGGTATGTAAT|TTCGTGTTTAGGTATGTAATCCTTGCATTC
CGGGCATCCGGAGTTCGTGTTTAGGTATGT|TAATCGGAGTTCGTGTTTAGGTATGTAATT
ATTTGGTATCCCTATGGAGGCATCCGGAGT|ATCCGGAGTTCGTGTTGCATCCGGAGTTCG
CGCCTCGGCATCCGGAGTTCGTGTTTAGGT|TTAAAAGAGGGGTAAGTCCTGTACTCGCAT
AATAGGTATGTAATTGCGCCGCATCCGGAG|CATTAGAGGGAGTCAGAGATGAAATATATC
GGGACTACTCAGACTTCGCCCCATTATTTG|GTATGTAATAATCTACGATGCCCGCATCCG
AGCATCCGGAGTTCGTGTTTAGGTATGTAA|CATATGATCCCATGGACTAGAATAACCAGT
CACGTATGTCGCGTCCGGAGACCTCCCGTC|GGAGTTCGTGTTTGCATCCGGAGTTCGTGT
CCCAATTATTCGGTACTCGTGCAATTTCGA|CCTATGGAGGCATCCGGAGTTCGTGTTTAG
TAGGTATGTAATCATAACGCCGTCAGGTCG|ATCCTTGCATTCCTGTAATCCGTATCTGGA
AGGTATGTAATTGCAGTTAGGTGAAGCTAC|AATAACCAGTGTGGCAGATATGTGGAGTAT
ACAAATGCAAGAGGCATAACCAGGCGAGGA|CGTGTTTAGGTATGTAATCGCATCCGGAGT
CCACCTAGATGTACGGACCCGTCTCGGGGA|GGTATGTAATAGCATCCGGAGTTCGTGTTT
TGAGGTAAGATTAGCGCTTTGACCGTTGCT|AGGGTAACCTCCTAGGCATCGCATCCGGAG
ATGTAATAATCTACGATGCCCGCATCCGGA|AGAGGCCCGGGCATCCGGAGTTCGTGTTTA
ATCCGGAGTTCGTGTTTAGGTATGTAATAG|GGGTAAGTCCTGTACTCGCATAGAGAAACA
CGCGAGTGAGGTAAGATTAGCGCTTTGACC|AAGTCGAGGGTAACCTCCTAGGCATCGCAT
GGTTATCACGCACAGTCCATTCGCCCATGC|CTACAATCGTTGCAATAAACTGGAGGCCAG
CGCCCCATTATTTGGTATCCCTATGGAGGC|GATGCCCGCATCCGGAGTTCGTGTTGCATC
AGGGTAACCTCCTAGGCATCGCATCCGGAG|TGGCAATCATGTTATTACACAAATGCAAGA
GACATAGCGAGCTCCGCATCCGGAGTTCGT|TAGGTATGTAATCATAACGCCGTCAGGTCG
CATAAATCGCACAGTATGACTAAAACTAAT|TATGTAATGGAGCGCGAGTGAGGTAAGATT
TGTAATAGCATCCGGAGTTCGTGTTTAGGT|GAGAAACATATGATCCCATGGACTAGAATA
CCGGAGTTCGTGTTTAGGTATGTAATCCAT|GAGTTCGTGTTTAGGTATGTAATTAGGTAT
ACTCGTGCAATTTCGAGTATTGGTCCACTA|CGGAGTTCGTGTTTAGGTATGTAATCCATA
GTATGTAATAGCATCCGGAGTTCGTGTTTA|ATAGAGAAACATATGATCCCATGGACTAGA
AGTTCGTGTTTAGGTATGTAATAATCTACG|GTTGCTGTGCGGTAGAGAGGCCCGGGCATC
CACCTTAGGCGCCCTGTGAGGGACTACTCA|ATCCGGAGTTCGTGTTTAGGTATGTAATAA
GAGTATCAACCCGAAAGTTTGATTAGAATG|TCGAGTATTGGTCCACTATCACGAACAGCG
TTTACTACAATCGTTGCAATAAACTGGAGG|GAAAGTTTGATTAGAATGAATCTGACTTGC
GGAGGCCAGCCTTTAAAAGAGGGGTAAGTC|CTTGCATCCGGAGTTCGTGTTTAGGTATGT
GGCGCCCTGTGAGGGACTACTCAGACTTCG|GTTCGTGTTTAGGTATGTAATAATCTACGA
GCCCGGGCATCCGGAGTTCGTGTTTAGGTA|ATGTAATCGGAGTTCGTGTTTAGGTATGTA
GTGTTTAGGTATGTAATCGCATCCGGAGTT|AATGTAACGCATCCGGAGTTCGTGTTTAGG
GTACGGACCCGTCTCGGGGATCCCCACTTG|AGCATCCGGAGTTCGTGTTTAGGTATGTAA
CGTCGAAGGATGCTGTAATAGTACCCCCTG|GTGTTTAGGTATGTAATAGGTATGTAATTG
TAAGATTAGCGCTTTGACCGTTGCTGTGCG|AACCTCCTAGGCATCGCATCCGGAGTTCGT
ATCCGGAGTTCGTGTTTAGGTATGTAATAA|TTGACCGTTGCTGTGCGGTAGAGAGGCCCG
GTCGCGTCCGGAGACCTCCCGTCGAAGGAT|GTGTTTGCATCCGGAGTTCGTGTTTAGGTA
AACAGCGGCTTGGGTGTCAGGCTTCTGCAC|CACAGTATGACTAAAACTAATTGATGCATC
CCCGTCGAAGGATGCTGTAATAGTACCCCC|TCGTGTTTAGGTATGTAATAGGTATGTAAT
TATGTAATTGCGCCGCATCCGGAGTTCGTG|AGGGAGTCAGAGATGAAATATATCACCAAT
TACTATCTGCATACCCAATTATTCGGTACT|ATTATTTGGTATCCCTATGGAGGCATCCGG
TCCGGAGTTCGTGTTGCATCCGGAGTTCGT|TGTTTAGGTATGTAATGACGTTGTTTTACT
GTATTGGTCCACTATCACGAACAGCGGCTT|GTATGTAATCCATAAATCGCACAGTATGAC
TTGCGCCGCATCCGGAGTTCGTGTTTAGGT|CAGAGATGAAATATATCACCAATGTAACGC
TAATTCACGTATGTCGCGTCCGGAGACCTC|CATCCGGAGTTCGTGTTTGCATCCGGAGTT
CATCCGGAGTTCGTGTTTAGGTATGTAATC|CCGGAGTTCGTGTTTAGGTATGTAATTAGG
TTTAGGTATGTAATGGATCGAGCCTCGATA|AGGCGCCCTGTGAGGGACTACTCAGACTTC
TTCGCCCATGCTGGCGCCTCGGCATCCGGA|CTGGAGGCCAGCCTTTAAAAGAGGGGTAAG
AAACTGGAGGCCAGCCTTTAAAAGAGGGGT|TCTGACTTGCATCCGGAGTTCGTGTTTAGG
TTGATGCATCCGGAGTTCGTGTTTAGGTAT|TAGCGCTTTGACCGTTGCTGTGCGGTAGAG
GGCATCCGGAGTTCGTGTTTAGGTATGTAA|ATCCGGAGTTCGTGTTTAGGTATGTAATTA
CGGAGTTCGTGTTTAGGTATGTAATCATAA|GTTTAGGTATGTAATCCTTGCATTCCTGTA
ATCTGACTTGCATCCGGAGTTCGTGTTTAG|CTTGGGTGTCAGGCTTCTGCACCTTAGGCG
AACTAATTGATGCATCCGGAGTTCGTGTTT|TAAGATTAGCGCTTTGACCGTTGCTGTGCG
TTAGGTATGTAATGGATCGAGCCTCGATAC|GGCGCCCTGTGAGGGACTACTCAGACTTCG
GAGGGTTATCACGCACAGTCCATTCGCCCA|TTACTACAATCGTTGCAATAAACTGGAGGC
GGATGCTGTAATAGTACCCCCTGGCAATCA|GGTATGTAATAGGTATGTAATTGCGCCGCA
CTATGGAGGCATCCGGAGTTCGTGTTTAGG|GTGTTGCATCCGGAGTTCGTGTTTAGGTAT
GAAGCTACCAAATTTTTACTACAATCGTTG|TGGAGTATCAACCCGAAAGTTTGATTAGAA
GTTTAGGTATGTAATTGCAGTTAGGTGAAG|CTAGAATAACCAGTGTGGCAGATATGTGGA
CCCCATTATTTGGTATCCCTATGGAGGCAT|TGCCCGCATCCGGAGTTCGTGTTGCATCCG
ATCCGGAGTTCGTGTTTAGGTATGTAATCG|ATGCAAGAGGCATAACCAGGCGAGGATGTA
GACTAAAACTAATTGATGCATCCGGAGTTC|GTGAGGTAAGATTAGCGCTTTGACCGTTGC
ATAGTACCCCCTGGCAATCATGTTATTACA|AGGTATGTAATTGCGCCGCATCCGGAGTTC
AGTTCGTGTTTAGGTATGTAATTAGGTATG|TTTTACTCTTCTGGGTGCGAACGCCCGTAG
ACGCCCGTAGGTTTCGTAAAGTCGAGGGTA|GAAGGATGCTGTAATAGTACCCCCTGGCAA
GTGGCAGATATGTGGAGTATCAACCCGAAA|GTACTCGTGCAATTTCGAGTATTGGTCCAC
ACTACAATCGTTGCAATAAACTGGAGGCCA|AGTTTGATTAGAATGAATCTGACTTGCATC
ATAAACTGGAGGCCAGCCTTTAAAAGAGGG|AATCTGACTTGCATCCGGAGTTCGTGTTTA
AAGTCGAGGGTAACCTCCTAGGCATCGCAT|ACCCCCTGGCAATCATGTTATTACACAAAT
TAGCATCCGGAGTTCGTGTTTAGGTATGTA|ACATATGATCCCATGGACTAGAATAACCAG
AATCCATAAATCGCACAGTATGACTAAAAC|TAGGTATGTAATGGAGCGCGAGTGAGGTAA
GTAATCGGAGTTCGTGTTTAGGTATGTAAT|GGATGTAGGTGACATAGCGAGCTCCGCATC
GGTTTCGTAAAGTCGAGGGTAACCTCCTAG|TGTAATAGTACCCCCTGGCAATCATGTTAT
AGTCCATTCGCCCATGCTGGCGCCTCGGCA|AATAAACTGGAGGCCAGCCTTTAAAAGAGG
TCGTGTTTAGGTATGTAATAGCATCCGGAG|CTGTACTCGCATAGAGAAACATATGATCCC
GTTTGCATCCGGAGTTCGTGTTTAGGTATG|CGTGTCCCCCCACAGGAATCACGGTTGTCC
TCCGGAGTTCGTGTTTAGGTATGTAATGAC|GAGTTCGTGTTTAGGTATGTAATTCACGTA
ATCCCCACTTGGGTCAATCCGGCGGGTCTG|TAGGTATGTAATTGCAGTTAGGTGAAGCTA
TAGAATGAATCTGACTTGCATCCGGAGTTC|AACAGCGGCTTGGGTGTCAGGCTTCTGCAC
CGTGTTTAGGTATGTAATCCATAAATCGCA|GTTTAGGTATGTAATTAGGTATGTAATGGA
CGCCGCATCCGGAGTTCGTGTTTAGGTATG|AGATGAAATATATCACCAATGTAACGCATC
CAGACTTCGCCCCATTATTTGGTATCCCTA|AATCTACGATGCCCGCATCCGGAGTTCGTG
TCCGAGAATCGTTAGTGGCTTTAGGTAGGT|CATGCTGGCGCCTCGGCATCCGGAGTTCGT
CCGGAGTTCGTGTTGCATCCGGAGTTCGTG|GTTTAGGTATGTAATGACGTTGTTTTACTC
GTTCGTGTTGCATCCGGAGTTCGTGTTTAG|GGTATGTAATGACGTTGTTTTACTCTTCTG
ATGCTGTAATAGTACCCCCTGGCAATCATG|TATGTAATAGGTATGTAATTGCGCCGCATC
CTGGCAATCATGTTATTACACAAATGCAAG|TTGCGCCGCATCCGGAGTTCGTGTTTAGGT
GTTGCAATAAACTGGAGGCCAGCCTTTAAA|AGAATGAATCTGACTTGCATCCGGAGTTCG
AGGTATGTAATCGGAGTTCGTGTTTAGGTA|AGGCGAGGATGTAGGTGACATAGCGAGCTC
GGTATGTAATGGAGCGCGAGTGAGGTAAGA|CCGTAGGTTTCGTAAAGTCGAGGGTAACCT
AGCTACCAAATTTTTACTACAATCGTTGCA|GAGTATCAACCCGAAAGTTTGATTAGAATG
AATTATTCGGTACTCGTGCAATTTCGAGTA|ATGGAGGCATCCGGAGTTCGTGTTTAGGTA
AACGCCCGTAGGTTTCGTAAAGTCGAGGGT|CGAAGGATGCTGTAATAGTACCCCCTGGCA
TACCAAATTTTTACTACAATCGTTGCAATA|TATCAACCCGAAAGTTTGATTAGAATGAAT
CCGGAGTTCGTGTTTAGGTATGTAATGACG|AGTTCGTGTTTAGGTATGTAATTCACGTAT
CCTAGGCATCGCATCCGGAGTTCGTGTTTA|GTTATTACACAAATGCAAGAGGCATAACCA
GGAGTTCGTGTTGCATCCGGAGTTCGTGTT|TTAGGTATGTAATGACGTTGTTTTACTCTT
GCATCCGGAGTTCGTGTTTAGGTATGTAAT|GAAATATATCACCAATGTAACGCATCCGGA
TTTAAAAGAGGGGTAAGTCCTGTACTCGCA|AGTTCGTGTTTAGGTATGTAATGGATCGAG
CTGTGCGGTAGAGAGGCCCGGGCATCCGGA|AGTTCGTGTTTAGGTATGTAATCGGAGTTC
CCCTATGGAGGCATCCGGAGTTCGTGTTTA|TCGTGTTGCATCCGGAGTTCGTGTTTAGGT
TGTCAGGCTTCTGCACCTTAGGCGCCCTGT|AACTAATTGATGCATCCGGAGTTCGTGTTT
CTACAATCGTTGCAATAAACTGGAGGCCAG|GTTTGATTAGAATGAATCTGACTTGCATCC
ATGTTATTACACAAATGCAAGAGGCATAAC|ATCCGGAGTTCGTGTTTAGGTATGTAATCG
CAATCGTTGCAATAAACTGGAGGCCAGCCT|TGATTAGAATGAATCTGACTTGCATCCGGA
TATTACACAAATGCAAGAGGCATAACCAGG|GGAGTTCGTGTTTAGGTATGTAATCGCATC
GTTTACTATCTGCATACCCAATTATTCGGT|CCCATTATTTGGTATCCCTATGGAGGCATC
TCCACTATCACGAACAGCGGCTTGGGTGTC|ATCCATAAATCGCACAGTATGACTAAAACT
ATGTAATCCATAAATCGCACAGTATGACTA|TAATTAGGTATGTAATGGAGCGCGAGTGAG
AATTGATGCATCCGGAGTTCGTGTTTAGGT|ATTAGCGCTTTGACCGTTGCTGTGCGGTAG
GATCCCATGGACTAGAATAACCAGTGTGGC|TACTATCTGCATACCCAATTATTCGGTACT
GTTCGTGTTTAGGTATGTAATCGCATCCGG|CACCAATGTAACGCATCCGGAGTTCGTGTT
GCGCGAGTGAGGTAAGATTAGCGCTTTGAC|AAAGTCGAGGGTAACCTCCTAGGCATCGCA
TGAGGGACTACTCAGACTTCGCCCCATTAT|TAGGTATGTAATAATCTACGATGCCCGCAT
ATGTACGGACCCGTCTCGGGGATCCCCACT|ATAGCATCCGGAGTTCGTGTTTAGGTATGT
GTATCAACCCGAAAGTTTGATTAGAATGAA|GAGTATTGGTCCACTATCACGAACAGCGGC
TTTTAATCGACTTTGGTCCGAGAATCGTTA|GCACAGTCCATTCGCCCATGCTGGCGCCTC
TAAACTGGAGGCCAGCCTTTAAAAGAGGGG|ATCTGACTTGCATCCGGAGTTCGTGTTTAG
TTATTACACAAATGCAAGAGGCATAACCAG|CGGAGTTCGTGTTTAGGTATGTAATCGCAT
GAGTTCGTGTTTAGGTATGTAATCCATAAA|TTCGTGTTTAGGTATGTAATTAGGTATGTA
GGCTTTAGGTAGGTGCTGGCCACCTAGATG|CATCCGGAGTTCGTGTTTAGGTATGTAATA
AAGAGGGGTAAGTCCTGTACTCGCATAGAG|GTGTTTAGGTATGTAATGGATCGAGCCTCG
TTCGTGTTGCATCCGGAGTTCGTGTTTAGG|GTATGTAATGACGTTGTTTTACTCTTCTGG
AATAACCAGTGTGGCAGATATGTGGAGTAT|CAATTATTCGGTACTCGTGCAATTTCGAGT
GGTAGAGAGGCCCGGGCATCCGGAGTTCGT|TGTTTAGGTATGTAATCGGAGTTCGTGTTT
CGGAGTTCGTGTTTAGGTATGTAATAATCT|ACCGTTGCTGTGCGGTAGAGAGGCCCGGGC
CCGGAGTTCGTGTTTAGGTATGTAATAATC|GACCGTTGCTGTGCGGTAGAGAGGCCCGGG
CTGGGTGCGAACGCCCGTAGGTTTCGTAAA|ACCTCCCGTCGAAGGATGCTGTAATAGTAC
GAGAATCGTTAGTGGCTTTAGGTAGGTGCT|GCTGGCGCCTCGGCATCCGGAGTTCGTGTT
TGCCCGCATCCGGAGTTCGTGTTGCATCCG|GGAGTTCGTGTTTAGGTATGTAATGACGTT
TCCGGAGTTCGTGTTTAGGTATGTAATGGA|GCTTCTGCACCTTAGGCGCCCTGTGAGGGA
ATGTAATGGATCGAGCCTCGATACAGTTTA|CTGTGAGGGACTACTCAGACTTCGCCCCAT
GTATGTAATCGCATCCGGAGTTCGTGTTTA|GCATCCGGAGTTCGTGTTTAGGTATGTAAT
ATAGCGAGCTCCGCATCCGGAGTTCGTGTT|GTATGTAATCATAACGCCGTCAGGTCGCGT
ATTAGGTATGTAATGGAGCGCGAGTGAGGT|ACGCCCGTAGGTTTCGTAAAGTCGAGGGTA
AATCATGTTATTACACAAATGCAAGAGGCA|CCGCATCCGGAGTTCGTGTTTAGGTATGTA
ACCTAGATGTACGGACCCGTCTCGGGGATC|TATGTAATAGCATCCGGAGTTCGTGTTTAG
CTCGATACAGTTTACTATCTGCATACCCAA|AGACTTCGCCCCATTATTTGGTATCCCTAT
GTAATTGCAGTTAGGTGAAGCTACCAAATT|CAGTGTGGCAGATATGTGGAGTATCAACCC
TGCATCCGGAGTTCGTGTTTAGGTATGTAA|ATGACGTTGTTTTACTCTTCTGGGTGCGAA
ATCTGCATACCCAATTATTCGGTACTCGTG|TTTGGTATCCCTATGGAGGCATCCGGAGTT
GACTTGCATCCGGAGTTCGTGTTTAGGTAT|GGTGTCAGGCTTCTGCACCTTAGGCGCCCT
GTTTTACTCTTCTGGGTGCGAACGCCCGTA|CGCGTCCGGAGACCTCCCGTCGAAGGATGC
ATAATCTACGATGCCCGCATCCGGAGTTCG|CCCGGGCATCCGGAGTTCGTGTTTAGGTAT
CCATTATTTGGTATCCCTATGGAGGCATCC|CCCGCATCCGGAGTTCGTGTTGCATCCGGA
GTGCTGGCCACCTAGATGTACGGACCCGTC|GTGTTTAGGTATGTAATAGCATCCGGAGTT
ACTAGAATAACCAGTGTGGCAGATATGTGG|ATACCCAATTATTCGGTACTCGTGCAATTT
TTTACTCTTCTGGGTGCGAACGCCCGTAGG|CGTCCGGAGACCTCCCGTCGAAGGATGCTG
TTTAGGTATGTAATCATAACGCCGTCAGGT|TAATCCTTGCATTCCTGTAATCCGTATCTG
GCCACCTAGATGTACGGACCCGTCTCGGGG|AGGTATGTAATAGCATCCGGAGTTCGTGTT
TGATCCCATGGACTAGAATAACCAGTGTGG|TTACTATCTGCATACCCAATTATTCGGTAC
TAATTGATGCATCCGGAGTTCGTGTTTAGG|GATTAGCGCTTTGACCGTTGCTGTGCGGTA
CAAATGCAAGAGGCATAACCAGGCGAGGAT|GTGTTTAGGTATGTAATCGCATCCGGAGTT
TGGGTCAATCCGGCGGGTCTGCGCCTTCCG|AATTGCAGTTAGGTGAAGCTACCAAATTTT
TGTGGAGTATCAACCCGAAAGTTTGATTAG|AATTTCGAGTATTGGTCCACTATCACGAAC
TTCTGCACCTTAGGCGCCCTGTGAGGGACT|GATGCATCCGGAGTTCGTGTTTAGGTATGT
GATGCATCCGGAGTTCGTGTTTAGGTATGT|GCGCTTTGACCGTTGCTGTGCGGTAGAGAG
GGTAGGTGCTGGCCACCTAGATGTACGGAC|AGTTCGTGTTTAGGTATGTAATAGCATCCG
GCATCCGGAGTTCGTGTTTAGGTATGTAAT|ATATGATCCCATGGACTAGAATAACCAGTG
TCAACCCGAAAGTTTGATTAGAATGAATCT|TATTGGTCCACTATCACGAACAGCGGCTTG
AATGGAGCGCGAGTGAGGTAAGATTAGCGC|TTTCGTAAAGTCGAGGGTAACCTCCTAGGC
TAGAATAACCAGTGTGGCAGATATGTGGAG|ACCCAATTATTCGGTACTCGTGCAATTTCG
CGTGTCCCCCCACAGGAATCACGGTTGTCC|CCGCCATGTTAGGCCTTACAACGGGAATAC
TTTGGTCCGAGAATCGTTAGTGGCTTTAGG|TCGCCCATGCTGGCGCCTCGGCATCCGGAG
CCGGAGACCTCCCGTCGAAGGATGCTGTAA|CATCCGGAGTTCGTGTTTAGGTATGTAATA
CGCATCCGGAGTTCGTGTTGCATCCGGAGT|TTCGTGTTTAGGTATGTAATGACGTTGTTT
CGGAGTTCGTGTTTAGGTATGTAATGACGT|GTTCGTGTTTAGGTATGTAATTCACGTATG
GAGTTCGTGTTTAGGTATGTAATCATAACG|TTAGGTATGTAATCCTTGCATTCCTGTAAT
ATGCTGGCGCCTCGGCATCCGGAGTTCGTG|CCAGCCTTTAAAAGAGGGGTAAGTCCTGTA
TCAATCCGGCGGGTCTGCGCCTTCCGAGGG|GCAGTTAGGTGAAGCTACCAAATTTTTACT
CATGCTGGCGCCTCGGCATCCGGAGTTCGT|GCCAGCCTTTAAAAGAGGGGTAAGTCCTGT
TTTTACTACAATCGTTGCAATAAACTGGAG|CGAAAGTTTGATTAGAATGAATCTGACTTG
GGACTACTCAGACTTCGCCCCATTATTTGG|TATGTAATAATCTACGATGCCCGCATCCGG
CTTGGGTGTCAGGCTTCTGCACCTTAGGCG|GACTAAAACTAATTGATGCATCCGGAGTTC
TAATTGCAGTTAGGTGAAGCTACCAAATTT|AGTGTGGCAGATATGTGGAGTATCAACCCG
CATCCGGAGTTCGTGTTTAGGTATGTAATT|TATGATCCCATGGACTAGAATAACCAGTGT
TTAGGTATGTAATAGGTATGTAATTGCGCC|CGGTTGTCCGCATTAGAGGGAGTCAGAGAT
TCTGCGCCTTCCGAGGGTTATCACGCACAG|GCTACCAAATTTTTACTACAATCGTTGCAA
CGAACGCCCGTAGGTTTCGTAAAGTCGAGG|GTCGAAGGATGCTGTAATAGTACCCCCTGG
TTACTACAATCGTTGCAATAAACTGGAGGC|AAAGTTTGATTAGAATGAATCTGACTTGCA
CCCATTATTTGGTATCCCTATGGAGGCATC|GCCCGCATCCGGAGTTCGTGTTGCATCCGG
GCGAACGCCCGTAGGTTTCGTAAAGTCGAG|CGTCGAAGGATGCTGTAATAGTACCCCCTG
GGCGAGGATGTAGGTGACATAGCGAGCTCC|TCCGGAGTTCGTGTTTAGGTATGTAATCAT
TACAATCGTTGCAATAAACTGGAGGCCAGC|TTTGATTAGAATGAATCTGACTTGCATCCG
GTACTCGCATAGAGAAACATATGATCCCAT|TGGATCGAGCCTCGATACAGTTTACTATCT
CTTCTGCACCTTAGGCGCCCTGTGAGGGAC|TGATGCATCCGGAGTTCGTGTTTAGGTATG
TGTTTAGGTATGTAATCATAACGCCGTCAG|TGTAATCCTTGCATTCCTGTAATCCGTATC
CATAGAGAAACATATGATCCCATGGACTAG|AGCCTCGATACAGTTTACTATCTGCATACC
CTCCTAGGCATCGCATCCGGAGTTCGTGTT|ATGTTATTACACAAATGCAAGAGGCATAAC
TGTCGCGTCCGGAGACCTCCCGTCGAAGGA|CGTGTTTGCATCCGGAGTTCGTGTTTAGGT
GAGGATGTAGGTGACATAGCGAGCTCCGCA|GGAGTTCGTGTTTAGGTATGTAATCATAAC
AAAGTTTGATTAGAATGAATCTGACTTGCA|CACTATCACGAACAGCGGCTTGGGTGTCAG
TATGGAGGCATCCGGAGTTCGTGTTTAGGT|TGTTGCATCCGGAGTTCGTGTTTAGGTATG
TATGTAATCGCATCCGGAGTTCGTGTTTAG|CATCCGGAGTTCGTGTTTAGGTATGTAATC
TTAGGTATGTAATGACGTTGTTTTACTCTT|GTATGTAATTCACGTATGTCGCGTCCGGAG
GTGCAATTTCGAGTATTGGTCCACTATCAC|GTTCGTGTTTAGGTATGTAATCCATAAATC
TGGCAATCATGTTATTACACAAATGCAAGA|TGCGCCGCATCCGGAGTTCGTGTTTAGGTA
GGTATGTAATCATAACGCCGTCAGGTCGCG|CCTTGCATTCCTGTAATCCGTATCTGGACC
TATGTCGCGTCCGGAGACCTCCCGTCGAAG|TTCGTGTTTGCATCCGGAGTTCGTGTTTAG
AATCATAACGCCGTCAGGTCGCGTGTCCCC|TTCCTGTAATCCGTATCTGGACCGCCATGT
GTATGACTAAAACTAATTGATGCATCCGGA|GCGAGTGAGGTAAGATTAGCGCTTTGACCG
CCACTTGGGTCAATCCGGCGGGTCTGCGCC|TATGTAATTGCAGTTAGGTGAAGCTACCAA
ATTCACGTATGTCGCGTCCGGAGACCTCCC|TCCGGAGTTCGTGTTTGCATCCGGAGTTCG
GGGTAACCTCCTAGGCATCGCATCCGGAGT|GGCAATCATGTTATTACACAAATGCAAGAG
ACCCGAAAGTTTGATTAGAATGAATCTGAC|TGGTCCACTATCACGAACAGCGGCTTGGGT
GGAGTTCGTGTTTAGGTATGTAATCGGAGT|AAGAGGCATAACCAGGCGAGGATGTAGGTG
TAAAGTCGAGGGTAACCTCCTAGGCATCGC|GTACCCCCTGGCAATCATGTTATTACACAA
GATGTACGGACCCGTCTCGGGGATCCCCAC|AATAGCATCCGGAGTTCGTGTTTAGGTATG
ATCCGGAGTTCGTGTTTAGGTATGTAATGG|GGCTTCTGCACCTTAGGCGCCCTGTGAGGG
GCACCTTAGGCGCCCTGTGAGGGACTACTC|CATCCGGAGTTCGTGTTTAGGTATGTAATA
ACAGCGGCTTGGGTGTCAGGCTTCTGCACC|ACAGTATGACTAAAACTAATTGATGCATCC
GTATCCCTATGGAGGCATCCGGAGTTCGTG|GAGTTCGTGTTGCATCCGGAGTTCGTGTTT
AGTGTGGCAGATATGTGGAGTATCAACCCG|TCGGTACTCGTGCAATTTCGAGTATTGGTC
CATAGCGAGCTCCGCATCCGGAGTTCGTGT|GGTATGTAATCATAACGCCGTCAGGTCGCG
GTCCATTCGCCCATGCTGGCGCCTCGGCAT|ATAAACTGGAGGCCAGCCTTTAAAAGAGGG
ACATATGATCCCATGGACTAGAATAACCAG|ACAGTTTACTATCTGCATACCCAATTATTC
GTTCGTGTTTAGGTATGTAATGACGTTGTT|GTGTTTAGGTATGTAATTCACGTATGTCGC
GCGAGTGAGGTAAGATTAGCGCTTTGACCG|AGTCGAGGGTAACCTCCTAGGCATCGCATC
TATCAACCCGAAAGTTTGATTAGAATGAAT|AGTATTGGTCCACTATCACGAACAGCGGCT
ATCACGAACAGCGGCTTGGGTGTCAGGCTT|AAATCGCACAGTATGACTAAAACTAATTGA
AGCGCGAGTGAGGTAAGATTAGCGCTTTGA|TAAAGTCGAGGGTAACCTCCTAGGCATCGC
ATTGCGCCGCATCCGGAGTTCGTGTTTAGG|TCAGAGATGAAATATATCACCAATGTAACG
AGTGGCTTTAGGTAGGTGCTGGCCACCTAG|CGGCATCCGGAGTTCGTGTTTAGGTATGTA
TCGTGTTTAGGTATGTAATTAGGTATGTAA|TACTCTTCTGGGTGCGAACGCCCGTAGGTT
ATCCCTATGGAGGCATCCGGAGTTCGTGTT|GTTCGTGTTGCATCCGGAGTTCGTGTTTAG
TTCGTGTTTAGGTATGTAATCGCATCCGGA|ACCAATGTAACGCATCCGGAGTTCGTGTTT
ATCCGGAGTTCGTGTTTAGGTATGTAATTA|ACGTTGTTTTACTCTTCTGGGTGCGAACGC
CGGTTGTCCGCATTAGAGGGAGTCAGAGAT|CGGGAATACGTGCGATCTATTTCATCACCT
CGGCATCCGGAGTTCGTGTTTAGGTATGTA|AGAGGGGTAAGTCCTGTACTCGCATAGAGA
AGGTTTCGTAAAGTCGAGGGTAACCTCCTA|CTGTAATAGTACCCCCTGGCAATCATGTTA
TTCGTGTTTAGGTATGTAATTGCAGTTAGG|ATGGACTAGAATAACCAGTGTGGCAGATAT
GCATCCGGAGTTCGTGTTTAGGTATGTAAT|TGACGTTGTTTTACTCTTCTGGGTGCGAAC
GTAATCCATAAATCGCACAGTATGACTAAA|ATTAGGTATGTAATGGAGCGCGAGTGAGGT
AGGCGCCCTGTGAGGGACTACTCAGACTTC|AGTTCGTGTTTAGGTATGTAATAATCTACG
GTTTAGGTATGTAATCCATAAATCGCACAG|TAGGTATGTAATTAGGTATGTAATGGAGCG
CCTGTACTCGCATAGAGAAACATATGATCC|TAATGGATCGAGCCTCGATACAGTTTACTA
TCGTGTTTAGGTATGTAATAATCTACGATG|GCTGTGCGGTAGAGAGGCCCGGGCATCCGG
TCGTGTTGCATCCGGAGTTCGTGTTTAGGT|TATGTAATGACGTTGTTTTACTCTTCTGGG
CCCGAAAGTTTGATTAGAATGAATCTGACT|GGTCCACTATCACGAACAGCGGCTTGGGTG
AGGCCCGGGCATCCGGAGTTCGTGTTTAGG|GTATGTAATCGGAGTTCGTGTTTAGGTATG
CGTAAAGTCGAGGGTAACCTCCTAGGCATC|TAGTACCCCCTGGCAATCATGTTATTACAC
GAACAGCGGCTTGGGTGTCAGGCTTCTGCA|GCACAGTATGACTAAAACTAATTGATGCAT
CATCCGGAGTTCGTGTTGCATCCGGAGTTC|CGTGTTTAGGTATGTAATGACGTTGTTTTA
ATGTAATGACGTTGTTTTACTCTTCTGGGT|AATTCACGTATGTCGCGTCCGGAGACCTCC
TCCGGAGTTCGTGTTTAGGTATGTAATTGC|TGATCCCATGGACTAGAATAACCAGTGTGG
GAGGTAAGATTAGCGCTTTGACCGTTGCTG|GGGTAACCTCCTAGGCATCGCATCCGGAGT
CATTATTTGGTATCCCTATGGAGGCATCCG|CCGCATCCGGAGTTCGTGTTGCATCCGGAG
TAACCAGGCGAGGATGTAGGTGACATAGCG|ATCGCATCCGGAGTTCGTGTTTAGGTATGT
GCAAGAGGCATAACCAGGCGAGGATGTAGG|TAGGTATGTAATCGCATCCGGAGTTCGTGT
CTGTACTCGCATAGAGAAACATATGATCCC|AATGGATCGAGCCTCGATACAGTTTACTAT
GCATCCGGAGTTCGTGTTTAGGTATGTAAT|TCCGGAGTTCGTGTTTAGGTATGTAATTAG
ATCGTTAGTGGCTTTAGGTAGGTGCTGGCC|GCGCCTCGGCATCCGGAGTTCGTGTTTAGG
CCGGAGTTCGTGTTTAGGTATGTAATAGGT|CCCACAGGAATCACGGTTGTCCGCATTAGA
AACCCGAAAGTTTGATTAGAATGAATCTGA|TTGGTCCACTATCACGAACAGCGGCTTGGG
TGTAATTGCGCCGCATCCGGAGTTCGTGTT|GGAGTCAGAGATGAAATATATCACCAATGT
TTTGACCGTTGCTGTGCGGTAGAGAGGCCC|ATCGCATCCGGAGTTCGTGTTTAGGTATGT
GAGTTCGTGTTTAGGTATGTAATCGGAGTT|AGAGGCATAACCAGGCGAGGATGTAGGTGA
AGAGCTTTTAATCGACTTTGGTCCGAGAAT|ATCACGCACAGTCCATTCGCCCATGCTGGC
GCAATTTCGAGTATTGGTCCACTATCACGA|TCGTGTTTAGGTATGTAATCCATAAATCGC
CGCACAGTATGACTAAAACTAATTGATGCA|TGGAGCGCGAGTGAGGTAAGATTAGCGCTT
AGGTATGTAATGACGTTGTTTTACTCTTCT|ATGTAATTCACGTATGTCGCGTCCGGAGAC
CTGTAATAGTACCCCCTGGCAATCATGTTA|GTAATAGGTATGTAATTGCGCCGCATCCGG
GCCCGTAGGTTTCGTAAAGTCGAGGGTAAC|AGGATGCTGTAATAGTACCCCCTGGCAATC
TAGGTATGTAATTGCGCCGCATCCGGAGTT|TTAGAGGGAGTCAGAGATGAAATATATCAC
TAAATCGCACAGTATGACTAAAACTAATTG|TGTAATGGAGCGCGAGTGAGGTAAGATTAG
GACCTCCCGTCGAAGGATGCTGTAATAGTA|GGAGTTCGTGTTTAGGTATGTAATAGGTAT
TTATTTGGTATCCCTATGGAGGCATCCGGA|GCATCCGGAGTTCGTGTTGCATCCGGAGTT
ATGAATCTGACTTGCATCCGGAGTTCGTGT|GCGGCTTGGGTGTCAGGCTTCTGCACCTTA
CCGGAGTTCGTGTTTAGGTATGTAATAGCA|GTAAGTCCTGTACTCGCATAGAGAAACATA
GTTGTCCGCATTAGAGGGAGTCAGAGATGA|GGAATACGTGCGATCTATTTCATCACCTTA
CCGGGCATCCGGAGTTCGTGTTTAGGTATG|GTAATCGGAGTTCGTGTTTAGGTATGTAAT
TGTTGCATCCGGAGTTCGTGTTTAGGTATG|GTAATGACGTTGTTTTACTCTTCTGGGTGC
TAATAGTACCCCCTGGCAATCATGTTATTA|ATAGGTATGTAATTGCGCCGCATCCGGAGT
CCGGAGTTCGTGTTTGCATCCGGAGTTCGT|CCGTCAGGTCGCGTGTCCCCCCACAGGAAT
GTGTTTAGGTATGTAATAGCATCCGGAGTT|GTACTCGCATAGAGAAACATATGATCCCAT
CCATGGACTAGAATAACCAGTGTGGCAGAT|ATCTGCATACCCAATTATTCGGTACTCGTG
CCTCCTAGGCATCGCATCCGGAGTTCGTGT|CATGTTATTACACAAATGCAAGAGGCATAA
TGGAGCGCGAGTGAGGTAAGATTAGCGCTT|TCGTAAAGTCGAGGGTAACCTCCTAGGCAT
TGACGTTGTTTTACTCTTCTGGGTGCGAAC|CGTATGTCGCGTCCGGAGACCTCCCGTCGA
GCAGATATGTGGAGTATCAACCCGAAAGTT|CTCGTGCAATTTCGAGTATTGGTCCACTAT
CGTGTTTAGGTATGTAATAGGTATGTAATT|AATCACGGTTGTCCGCATTAGAGGGAGTCA
TGTAATAATCTACGATGCCCGCATCCGGAG|GAGGCCCGGGCATCCGGAGTTCGTGTTTAG
CGGAGACCTCCCGTCGAAGGATGCTGTAAT|ATCCGGAGTTCGTGTTTAGGTATGTAATAG
AGAGGGGTAAGTCCTGTACTCGCATAGAGA|TGTTTAGGTATGTAATGGATCGAGCCTCGA
GGTCCGAGAATCGTTAGTGGCTTTAGGTAG|CCCATGCTGGCGCCTCGGCATCCGGAGTTC
GTAAGATTAGCGCTTTGACCGTTGCTGTGC|TAACCTCCTAGGCATCGCATCCGGAGTTCG
GTAGAGAGGCCCGGGCATCCGGAGTTCGTG|GTTTAGGTATGTAATCGGAGTTCGTGTTTA
ATAGCATCCGGAGTTCGTGTTTAGGTATGT|AACATATGATCCCATGGACTAGAATAACCA
CGGAGTTCGTGTTTAGGTATGTAATAGCAT|TAAGTCCTGTACTCGCATAGAGAAACATAT
GTGAGGGACTACTCAGACTTCGCCCCATTA|TTAGGTATGTAATAATCTACGATGCCCGCA
TACTCGTGCAATTTCGAGTATTGGTCCACT|CCGGAGTTCGTGTTTAGGTATGTAATCCAT
AACATATGATCCCATGGACTAGAATAACCA|TACAGTTTACTATCTGCATACCCAATTATT
CGTGTTTAGGTATGTAATAATCTACGATGC|CTGTGCGGTAGAGAGGCCCGGGCATCCGGA
ACAGGAATCACGGTTGTCCGCATTAGAGGG|GGCCTTACAACGGGAATACGTGCGATCTAT
GCTTTTAATCGACTTTGGTCCGAGAATCGT|ACGCACAGTCCATTCGCCCATGCTGGCGCC
GTCGCGTGTCCCCCCACAGGAATCACGGTT|TGGACCGCCATGTTAGGCCTTACAACGGGA
TTTAGGTATGTAATAGGTATGTAATTGCGC|ACGGTTGTCCGCATTAGAGGGAGTCAGAGA
CTGGAGGCCAGCCTTTAAAAGAGGGGTAAG|GACTTGCATCCGGAGTTCGTGTTTAGGTAT
AAAGAGGGGTAAGTCCTGTACTCGCATAGA|CGTGTTTAGGTATGTAATGGATCGAGCCTC
TGTACGGACCCGTCTCGGGGATCCCCACTT|TAGCATCCGGAGTTCGTGTTTAGGTATGTA
TGGAGTATCAACCCGAAAGTTTGATTAGAA|TTTCGAGTATTGGTCCACTATCACGAACAG
CGAGTATTGGTCCACTATCACGAACAGCGG|TAGGTATGTAATCCATAAATCGCACAGTAT
GAAAGTTTGATTAGAATGAATCTGACTTGC|CCACTATCACGAACAGCGGCTTGGGTGTCA
TCCGGAGTTCGTGTTTAGGTATGTAATAGC|GGTAAGTCCTGTACTCGCATAGAGAAACAT
TCTACGATGCCCGCATCCGGAGTTCGTGTT|GGCATCCGGAGTTCGTGTTTAGGTATGTAA
TCGGAGTTCGTGTTTAGGTATGTAATTCAC|GTAGGTGACATAGCGAGCTCCGCATCCGGA
GGTGAAGCTACCAAATTTTTACTACAATCG|ATGTGGAGTATCAACCCGAAAGTTTGATTA
GTTTAGGTATGTAATGACGTTGTTTTACTC|AGGTATGTAATTCACGTATGTCGCGTCCGG
AGCTCCGCATCCGGAGTTCGTGTTTGCATC|AATCATAACGCCGTCAGGTCGCGTGTCCCC
AGGTATGTAATCATAACGCCGTCAGGTCGC|TCCTTGCATTCCTGTAATCCGTATCTGGAC
TCGCATAGAGAAACATATGATCCCATGGAC|TCGAGCCTCGATACAGTTTACTATCTGCAT
GTACCCCCTGGCAATCATGTTATTACACAA|TATGTAATTGCGCCGCATCCGGAGTTCGTG
GCATCCGGAGTTCGTGTTTAGGTATGTAAT|CAGGCTTCTGCACCTTAGGCGCCCTGTGAG
CTATCTGCATACCCAATTATTCGGTACTCG|TATTTGGTATCCCTATGGAGGCATCCGGAG
GCGTCCGGAGACCTCCCGTCGAAGGATGCT|TTTGCATCCGGAGTTCGTGTTTAGGTATGT
CCGTCGAAGGATGCTGTAATAGTACCCCCT|CGTGTTTAGGTATGTAATAGGTATGTAATT
CCTGGCAATCATGTTATTACACAAATGCAA|ATTGCGCCGCATCCGGAGTTCGTGTTTAGG
GAGCTCCGCATCCGGAGTTCGTGTTTGCAT|TAATCATAACGCCGTCAGGTCGCGTGTCCC
AGACTTCGCCCCATTATTTGGTATCCCTAT|ATCTACGATGCCCGCATCCGGAGTTCGTGT
AGGTAAGATTAGCGCTTTGACCGTTGCTGT|GGTAACCTCCTAGGCATCGCATCCGGAGTT
GTTTAGGTATGTAATAGCATCCGGAGTTCG|ACTCGCATAGAGAAACATATGATCCCATGG
TCGTGTTTAGGTATGTAATGGATCGAGCCT|ACCTTAGGCGCCCTGTGAGGGACTACTCAG
CGAGTGAGGTAAGATTAGCGCTTTGACCGT|GTCGAGGGTAACCTCCTAGGCATCGCATCC
TGCACCTTAGGCGCCCTGTGAGGGACTACT|GCATCCGGAGTTCGTGTTTAGGTATGTAAT
TGCTGGCGCCTCGGCATCCGGAGTTCGTGT|CAGCCTTTAAAAGAGGGGTAAGTCCTGTAC
CATCCGGAGTTCGTGTTTGCATCCGGAGTT|ACGCCGTCAGGTCGCGTGTCCCCCCACAGG
AATCCGGCGGGTCTGCGCCTTCCGAGGGTT|AGTTAGGTGAAGCTACCAAATTTTTACTAC
GGAGTTCGTGTTTAGGTATGTAATAGCATC|AAGTCCTGTACTCGCATAGAGAAACATATG
GTGCGGTAGAGAGGCCCGGGCATCCGGAGT|TTCGTGTTTAGGTATGTAATCGGAGTTCGT
TATGTAATAGCATCCGGAGTTCGTGTTTAG|TAGAGAAACATATGATCCCATGGACTAGAA
ATTATTCGGTACTCGTGCAATTTCGAGTAT|TGGAGGCATCCGGAGTTCGTGTTTAGGTAT
ACAATCGTTGCAATAAACTGGAGGCCAGCC|TTGATTAGAATGAATCTGACTTGCATCCGG
AGTCGAGGGTAACCTCCTAGGCATCGCATC|CCCCCTGGCAATCATGTTATTACACAAATG
AGGCATCCGGAGTTCGTGTTTAGGTATGTA|CATCCGGAGTTCGTGTTTAGGTATGTAATT
ACCCAATTATTCGGTACTCGTGCAATTTCG|CCCTATGGAGGCATCCGGAGTTCGTGTTTA
TTCGTGTTTGCATCCGGAGTTCGTGTTTAG|GGTCGCGTGTCCCCCCACAGGAATCACGGT
TGGAGGCCAGCCTTTAAAAGAGGGGTAAGT|ACTTGCATCCGGAGTTCGTGTTTAGGTATG
CCTTTAAAAGAGGGGTAAGTCCTGTACTCG|GGAGTTCGTGTTTAGGTATGTAATGGATCG
ACCCGTCTCGGGGATCCCCACTTGGGTCAA|CGGAGTTCGTGTTTAGGTATGTAATTGCAG
GGCGCCTCGGCATCCGGAGTTCGTGTTTAG|CTTTAAAAGAGGGGTAAGTCCTGTACTCGC
TAATCGGAGTTCGTGTTTAGGTATGTAATT|GATGTAGGTGACATAGCGAGCTCCGCATCC
GTTTAGGTATGTAATCGGAGTTCGTGTTTA|AACCAGGCGAGGATGTAGGTGACATAGCGA
ATGTAATAGCATCCGGAGTTCGTGTTTAGG|AGAGAAACATATGATCCCATGGACTAGAAT
GTCCACTATCACGAACAGCGGCTTGGGTGT|AATCCATAAATCGCACAGTATGACTAAAAC
ATCCGGAGTTCGTGTTTAGGTATGTAATTG|ATGATCCCATGGACTAGAATAACCAGTGTG
GGTATGTAATTAGGTATGTAATGGAGCGCG|GGGTGCGAACGCCCGTAGGTTTCGTAAAGT
TAGGCGCCCTGTGAGGGACTACTCAGACTT|GAGTTCGTGTTTAGGTATGTAATAATCTAC
TTAGGTATGTAATCCATAAATCGCACAGTA|GGTATGTAATTAGGTATGTAATGGAGCGCG
TATGTAATAATCTACGATGCCCGCATCCGG|GAGAGGCCCGGGCATCCGGAGTTCGTGTTT
CATCCGGAGTTCGTGTTTAGGTATGTAATG|AGGCTTCTGCACCTTAGGCGCCCTGTGAGG
GCATCCGGAGTTCGTGTTTAGGTATGTAAT|CTTTGACCGTTGCTGTGCGGTAGAGAGGCC
CTTTAAAAGAGGGGTAAGTCCTGTACTCGC|GAGTTCGTGTTTAGGTATGTAATGGATCGA
CCGAAAGTTTGATTAGAATGAATCTGACTT|GTCCACTATCACGAACAGCGGCTTGGGTGT
TACTCTTCTGGGTGCGAACGCCCGTAGGTT|TCCGGAGACCTCCCGTCGAAGGATGCTGTA
TTCGCCCCATTATTTGGTATCCCTATGGAG|ACGATGCCCGCATCCGGAGTTCGTGTTGCA
GGTAAGATTAGCGCTTTGACCGTTGCTGTG|GTAACCTCCTAGGCATCGCATCCGGAGTTC
TCTGCACCTTAGGCGCCCTGTGAGGGACTA|ATGCATCCGGAGTTCGTGTTTAGGTATGTA
TCACGAACAGCGGCTTGGGTGTCAGGCTTC|AATCGCACAGTATGACTAAAACTAATTGAT
CGTGTTTAGGTATGTAATTGCAGTTAGGTG|GGACTAGAATAACCAGTGTGGCAGATATGT
CCATAAATCGCACAGTATGACTAAAACTAA|GTATGTAATGGAGCGCGAGTGAGGTAAGAT
CAATAAACTGGAGGCCAGCCTTTAAAAGAG|TGAATCTGACTTGCATCCGGAGTTCGTGTT
ATTACACAAATGCAAGAGGCATAACCAGGC|GAGTTCGTGTTTAGGTATGTAATCGCATCC
CTTCCGAGGGTTATCACGCACAGTCCATTC|AATTTTTACTACAATCGTTGCAATAAACTG
TAGGTATGTAATGACGTTGTTTTACTCTTC|TATGTAATTCACGTATGTCGCGTCCGGAGA
GGGTTATCACGCACAGTCCATTCGCCCATG|ACTACAATCGTTGCAATAAACTGGAGGCCA
GTGTTTAGGTATGTAATGACGTTGTTTTAC|TTAGGTATGTAATTCACGTATGTCGCGTCC
GAGTTCGTGTTTAGGTATGTAATTAGGTAT|GTTTTACTCTTCTGGGTGCGAACGCCCGTA
GTAGGTGCTGGCCACCTAGATGTACGGACC|GTTCGTGTTTAGGTATGTAATAGCATCCGG
TATCTGCATACCCAATTATTCGGTACTCGT|ATTTGGTATCCCTATGGAGGCATCCGGAGT
TAATCGCATCCGGAGTTCGTGTTTAGGTAT|CGGAGTTCGTGTTTAGGTATGTAATCCTTG
TGTAATGGAGCGCGAGTGAGGTAAGATTAG|AGGTTTCGTAAAGTCGAGGGTAACCTCCTA
GTTCGTGTTTAGGTATGTAATCCATAAATC|CGTGTTTAGGTATGTAATTAGGTATGTAAT
TCCGGAGTTCGTGTTTAGGTATGTAATCCA|GGAGTTCGTGTTTAGGTATGTAATTAGGTA
TGACCGTTGCTGTGCGGTAGAGAGGCCCGG|CGCATCCGGAGTTCGTGTTTAGGTATGTAA
ACACAAATGCAAGAGGCATAACCAGGCGAG|TTCGTGTTTAGGTATGTAATCGCATCCGGA
CTTGCATCCGGAGTTCGTGTTTAGGTATGT|TGTCAGGCTTCTGCACCTTAGGCGCCCTGT
GTCAATCCGGCGGGTCTGCGCCTTCCGAGG|TGCAGTTAGGTGAAGCTACCAAATTTTTAC
TGACTTGCATCCGGAGTTCGTGTTTAGGTA|GGGTGTCAGGCTTCTGCACCTTAGGCGCCC
CTTAGGCGCCCTGTGAGGGACTACTCAGAC|CGGAGTTCGTGTTTAGGTATGTAATAATCT
TGAAGCTACCAAATTTTTACTACAATCGTT|GTGGAGTATCAACCCGAAAGTTTGATTAGA
TCCCGTCGAAGGATGCTGTAATAGTACCCC|TTCGTGTTTAGGTATGTAATAGGTATGTAA
TGTTTAGGTATGTAATCCATAAATCGCACA|TTAGGTATGTAATTAGGTATGTAATGGAGC
TAGGTATGTAATCGGAGTTCGTGTTTAGGT|CAGGCGAGGATGTAGGTGACATAGCGAGCT
TTTAATCGACTTTGGTCCGAGAATCGTTAG|CACAGTCCATTCGCCCATGCTGGCGCCTCG
CCCCACAGGAATCACGGTTGTCCGCATTAG|GTTAGGCCTTACAACGGGAATACGTGCGAT
CTGGCGCCTCGGCATCCGGAGTTCGTGTTT|GCCTTTAAAAGAGGGGTAAGTCCTGTACTC
ATCGCATCCGGAGTTCGTGTTTAGGTATGT|GAGTTCGTGTTTAGGTATGTAATCCTTGCA
TGGGTGCGAACGCCCGTAGGTTTCGTAAAG|CCTCCCGTCGAAGGATGCTGTAATAGTACC
ACTGGAGGCCAGCCTTTAAAAGAGGGGTAA|TGACTTGCATCCGGAGTTCGTGTTTAGGTA
GAGGCCCGGGCATCCGGAGTTCGTGTTTAG|GGTATGTAATCGGAGTTCGTGTTTAGGTAT
CAGTGTGGCAGATATGTGGAGTATCAACCC|TTCGGTACTCGTGCAATTTCGAGTATTGGT
GGCATAACCAGGCGAGGATGTAGGTGACAT|TGTAATCGCATCCGGAGTTCGTGTTTAGGT
TGTTTAGGTATGTAATAGGTATGTAATTGC|TCACGGTTGTCCGCATTAGAGGGAGTCAGA
TCGTGCAATTTCGAGTATTGGTCCACTATC|GAGTTCGTGTTTAGGTATGTAATCCATAAA
CGTAGGTTTCGTAAAGTCGAGGGTAACCTC|ATGCTGTAATAGTACCCCCTGGCAATCATG
GCATCCGGAGTTCGTGTTTGCATCCGGAGT|AACGCCGTCAGGTCGCGTGTCCCCCCACAG
GTTCGTGTTTAGGTATGTAATCGGAGTTCG|AGGCATAACCAGGCGAGGATGTAGGTGACA
GTAATAGTACCCCCTGGCAATCATGTTATT|AATAGGTATGTAATTGCGCCGCATCCGGAG
GTAATAGCATCCGGAGTTCGTGTTTAGGTA|AGAAACATATGATCCCATGGACTAGAATAA
TGTTTAGGTATGTAATAATCTACGATGCCC|GTGCGGTAGAGAGGCCCGGGCATCCGGAGT
GGTATCCCTATGGAGGCATCCGGAGTTCGT|GGAGTTCGTGTTGCATCCGGAGTTCGTGTT
GTGCGAACGCCCGTAGGTTTCGTAAAGTCG|CCCGTCGAAGGATGCTGTAATAGTACCCCC
CTACTCAGACTTCGCCCCATTATTTGGTAT|GTAATAATCTACGATGCCCGCATCCGGAGT
CCCTGTGAGGGACTACTCAGACTTCGCCCC|GTGTTTAGGTATGTAATAATCTACGATGCC
TTCGTGTTTAGGTATGTAATCGGAGTTCGT|GGCATAACCAGGCGAGGATGTAGGTGACAT
ACGTATGTCGCGTCCGGAGACCTCCCGTCG|GAGTTCGTGTTTGCATCCGGAGTTCGTGTT
CATCCGGAGTTCGTGTTTAGGTATGTAATA|CCCCCCACAGGAATCACGGTTGTCCGCATT
AAGTCCTGTACTCGCATAGAGAAACATATG|TATGTAATGGATCGAGCCTCGATACAGTTT
GTTTAGGTATGTAATTAGGTATGTAATGGA|CTTCTGGGTGCGAACGCCCGTAGGTTTCGT
TCGAGCCTCGATACAGTTTACTATCTGCAT|CTACTCAGACTTCGCCCCATTATTTGGTAT
TAGGTATGTAATAGCATCCGGAGTTCGTGT|CGCATAGAGAAACATATGATCCCATGGACT
TACGATGCCCGCATCCGGAGTTCGTGTTGC|CATCCGGAGTTCGTGTTTAGGTATGTAATG
ATCACGGTTGTCCGCATTAGAGGGAGTCAG|ACAACGGGAATACGTGCGATCTATTTCATC
CGCCCGTAGGTTTCGTAAAGTCGAGGGTAA|AAGGATGCTGTAATAGTACCCCCTGGCAAT
GCGGGTCTGCGCCTTCCGAGGGTTATCACG|GTGAAGCTACCAAATTTTTACTACAATCGT
TTTACTATCTGCATACCCAATTATTCGGTA|CCATTATTTGGTATCCCTATGGAGGCATCC
AGAGGCCCGGGCATCCGGAGTTCGTGTTTA|AGGTATGTAATCGGAGTTCGTGTTTAGGTA
GGACCCGTCTCGGGGATCCCCACTTGGGTC|TCCGGAGTTCGTGTTTAGGTATGTAATTGC
GTCGAGGGTAACCTCCTAGGCATCGCATCC|CCCCTGGCAATCATGTTATTACACAAATGC
TGGTCCACTATCACGAACAGCGGCTTGGGT|GTAATCCATAAATCGCACAGTATGACTAAA
CGAGCCTCGATACAGTTTACTATCTGCATA|TACTCAGACTTCGCCCCATTATTTGGTATC
CGGAGTTCGTGTTTAGGTATGTAATAGGTA|CCACAGGAATCACGGTTGTCCGCATTAGAG
AGCCTTTAAAAGAGGGGTAAGTCCTGTACT|CCGGAGTTCGTGTTTAGGTATGTAATGGAT
GTTCGTGTTTAGGTATGTAATGGATCGAGC|GCACCTTAGGCGCCCTGTGAGGGACTACTC
AGCGCTTTGACCGTTGCTGTGCGGTAGAGA|TAGGCATCGCATCCGGAGTTCGTGTTTAGG
TGTACTCGCATAGAGAAACATATGATCCCA|ATGGATCGAGCCTCGATACAGTTTACTATC
CGTGTTTAGGTATGTAATGACGTTGTTTTA|TTTAGGTATGTAATTCACGTATGTCGCGTC
GTTTGATTAGAATGAATCTGACTTGCATCC|TATCACGAACAGCGGCTTGGGTGTCAGGCT
CCGGAGTTCGTGTTTAGGTATGTAATTAGG|GTTGTTTTACTCTTCTGGGTGCGAACGCCC
TCCTAGGCATCGCATCCGGAGTTCGTGTTT|TGTTATTACACAAATGCAAGAGGCATAACC
GTGTGGCAGATATGTGGAGTATCAACCCGA|CGGTACTCGTGCAATTTCGAGTATTGGTCC
AGTATGACTAAAACTAATTGATGCATCCGG|CGCGAGTGAGGTAAGATTAGCGCTTTGACC
TCCGGCGGGTCTGCGCCTTCCGAGGGTTAT|TTAGGTGAAGCTACCAAATTTTTACTACAA
GCAGTTAGGTGAAGCTACCAAATTTTTACT|GGCAGATATGTGGAGTATCAACCCGAAAGT
ATGCATCCGGAGTTCGTGTTTAGGTATGTA|CGCTTTGACCGTTGCTGTGCGGTAGAGAGG
ATTGATGCATCCGGAGTTCGTGTTTAGGTA|TTAGCGCTTTGACCGTTGCTGTGCGGTAGA
TGTAATTGCAGTTAGGTGAAGCTACCAAAT|CCAGTGTGGCAGATATGTGGAGTATCAACC
ATGTAATCGCATCCGGAGTTCGTGTTTAGG|ATCCGGAGTTCGTGTTTAGGTATGTAATCC
TAATCTACGATGCCCGCATCCGGAGTTCGT|CCGGGCATCCGGAGTTCGTGTTTAGGTATG
TTTAGGTATGTAATCCATAAATCGCACAGT|AGGTATGTAATTAGGTATGTAATGGAGCGC
TTATTCGGTACTCGTGCAATTTCGAGTATT|GGAGGCATCCGGAGTTCGTGTTTAGGTATG
TGGCGCCTCGGCATCCGGAGTTCGTGTTTA|CCTTTAAAAGAGGGGTAAGTCCTGTACTCG
ACTATCACGAACAGCGGCTTGGGTGTCAGG|CATAAATCGCACAGTATGACTAAAACTAAT
TGCAAGAGGCATAACCAGGCGAGGATGTAG|TTAGGTATGTAATCGCATCCGGAGTTCGTG
TAAAAGAGGGGTAAGTCCTGTACTCGCATA|TTCGTGTTTAGGTATGTAATGGATCGAGCC
AGTTCGTGTTTAGGTATGTAATCGGAGTTC|GAGGCATAACCAGGCGAGGATGTAGGTGAC
CAATTTCGAGTATTGGTCCACTATCACGAA|CGTGTTTAGGTATGTAATCCATAAATCGCA
ATTTTTACTACAATCGTTGCAATAAACTGG|CCCGAAAGTTTGATTAGAATGAATCTGACT
TACTACAATCGTTGCAATAAACTGGAGGCC|AAGTTTGATTAGAATGAATCTGACTTGCAT
CTTTGGTCCGAGAATCGTTAGTGGCTTTAG|TTCGCCCATGCTGGCGCCTCGGCATCCGGA
ATTAGCGCTTTGACCGTTGCTGTGCGGTAG|TCCTAGGCATCGCATCCGGAGTTCGTGTTT
AGTTCGTGTTTAGGTATGTAATGACGTTGT|CGTGTTTAGGTATGTAATTCACGTATGTCG
TATGTAATCATAACGCCGTCAGGTCGCGTG|TTGCATTCCTGTAATCCGTATCTGGACCGC
GGCCCGGGCATCCGGAGTTCGTGTTTAGGT|TATGTAATCGGAGTTCGTGTTTAGGTATGT
TGACATAGCGAGCTCCGCATCCGGAGTTCG|TTAGGTATGTAATCATAACGCCGTCAGGTC
GTATGTAATGGAGCGCGAGTGAGGTAAGAT|CGTAGGTTTCGTAAAGTCGAGGGTAACCTC
AGAAACATATGATCCCATGGACTAGAATAA|CGATACAGTTTACTATCTGCATACCCAATT
GGTTGTCCGCATTAGAGGGAGTCAGAGATG|GGGAATACGTGCGATCTATTTCATCACCTT
ACGCACAGTCCATTCGCCCATGCTGGCGCC|CGTTGCAATAAACTGGAGGCCAGCCTTTAA
GTAATCATAACGCCGTCAGGTCGCGTGTCC|CATTCCTGTAATCCGTATCTGGACCGCCAT
CATCCGGAGTTCGTGTTTAGGTATGTAATA|GGGGTAAGTCCTGTACTCGCATAGAGAAAC
CCCCTGGCAATCATGTTATTACACAAATGC|TAATTGCGCCGCATCCGGAGTTCGTGTTTA
CTTTGACCGTTGCTGTGCGGTAGAGAGGCC|CATCGCATCCGGAGTTCGTGTTTAGGTATG
GCGAGCTCCGCATCCGGAGTTCGTGTTTGC|TGTAATCATAACGCCGTCAGGTCGCGTGTC
TAGGTGACATAGCGAGCTCCGCATCCGGAG|GTGTTTAGGTATGTAATCATAACGCCGTCA
CCGTCAGGTCGCGTGTCCCCCCACAGGAAT|CCGTATCTGGACCGCCATGTTAGGCCTTAC
GGAGGCATCCGGAGTTCGTGTTTAGGTATG|TGCATCCGGAGTTCGTGTTTAGGTATGTAA
CGCCTTCCGAGGGTTATCACGCACAGTCCA|CCAAATTTTTACTACAATCGTTGCAATAAA
TCCGGAGTTCGTGTTTAGGTATGTAATCAT|GTGTTTAGGTATGTAATCCTTGCATTCCTG
GTCTCGGGGATCCCCACTTGGGTCAATCCG|GTTCGTGTTTAGGTATGTAATTGCAGTTAG
TCGTGTTTAGGTATGTAATTCACGTATGTC|ACATAGCGAGCTCCGCATCCGGAGTTCGTG
GGCATCGCATCCGGAGTTCGTGTTTAGGTA|TTACACAAATGCAAGAGGCATAACCAGGCG
TATCCCTATGGAGGCATCCGGAGTTCGTGT|AGTTCGTGTTGCATCCGGAGTTCGTGTTTA
GTACTCGTGCAATTTCGAGTATTGGTCCAC|TCCGGAGTTCGTGTTTAGGTATGTAATCCA
TAACCAGTGTGGCAGATATGTGGAGTATCA|ATTATTCGGTACTCGTGCAATTTCGAGTAT
TTGGTCCACTATCACGAACAGCGGCTTGGG|TGTAATCCATAAATCGCACAGTATGACTAA
TCGTAAAGTCGAGGGTAACCTCCTAGGCAT|ATAGTACCCCCTGGCAATCATGTTATTACA
TGTTTAGGTATGTAATAGCATCCGGAGTTC|TACTCGCATAGAGAAACATATGATCCCATG
TCCCATGGACTAGAATAACCAGTGTGGCAG|CTATCTGCATACCCAATTATTCGGTACTCG
ACTACTCAGACTTCGCCCCATTATTTGGTA|TGTAATAATCTACGATGCCCGCATCCGGAG
AGGGGTAAGTCCTGTACTCGCATAGAGAAA|TTTAGGTATGTAATGGATCGAGCCTCGATA
GAGTTCGTGTTTAGGTATGTAATGGATCGA|CTGCACCTTAGGCGCCCTGTGAGGGACTAC
GATATGTGGAGTATCAACCCGAAAGTTTGA|GTGCAATTTCGAGTATTGGTCCACTATCAC
CGGCGGGTCTGCGCCTTCCGAGGGTTATCA|AGGTGAAGCTACCAAATTTTTACTACAATC
GAGCGCGAGTGAGGTAAGATTAGCGCTTTG|GTAAAGTCGAGGGTAACCTCCTAGGCATCG
CATCCGGAGTTCGTGTTTAGGTATGTAATA|TTTGACCGTTGCTGTGCGGTAGAGAGGCCC
CGCACAGTCCATTCGCCCATGCTGGCGCCT|GTTGCAATAAACTGGAGGCCAGCCTTTAAA
CTAGATGTACGGACCCGTCTCGGGGATCCC|TGTAATAGCATCCGGAGTTCGTGTTTAGGT
TTTCGAGTATTGGTCCACTATCACGAACAG|GTTTAGGTATGTAATCCATAAATCGCACAG
TTGGTCCGAGAATCGTTAGTGGCTTTAGGT|CGCCCATGCTGGCGCCTCGGCATCCGGAGT
ATGCAAGAGGCATAACCAGGCGAGGATGTA|TTTAGGTATGTAATCGCATCCGGAGTTCGT
TATGTAATTGCAGTTAGGTGAAGCTACCAA|AACCAGTGTGGCAGATATGTGGAGTATCAA
ATGCCCGCATCCGGAGTTCGTGTTGCATCC|CGGAGTTCGTGTTTAGGTATGTAATGACGT
AGCGGCTTGGGTGTCAGGCTTCTGCACCTT|AGTATGACTAAAACTAATTGATGCATCCGG
GGCAATCATGTTATTACACAAATGCAAGAG|GCGCCGCATCCGGAGTTCGTGTTTAGGTAT
GAGGGACTACTCAGACTTCGCCCCATTATT|AGGTATGTAATAATCTACGATGCCCGCATC
CGGGTCTGCGCCTTCCGAGGGTTATCACGC|TGAAGCTACCAAATTTTTACTACAATCGTT
AATTCACGTATGTCGCGTCCGGAGACCTCC|ATCCGGAGTTCGTGTTTGCATCCGGAGTTC
TGTTTAGGTATGTAATTCACGTATGTCGCG|TAGCGAGCTCCGCATCCGGAGTTCGTGTTT
GTGTTTAGGTATGTAATCGGAGTTCGTGTT|ATAACCAGGCGAGGATGTAGGTGACATAGC
AGGTATGTAATAGCATCCGGAGTTCGTGTT|GCATAGAGAAACATATGATCCCATGGACTA
TATCACGCACAGTCCATTCGCCCATGCTGG|CAATCGTTGCAATAAACTGGAGGCCAGCCT
TAATGGAGCGCGAGTGAGGTAAGATTAGCG|GTTTCGTAAAGTCGAGGGTAACCTCCTAGG
GCCGTCAGGTCGCGTGTCCCCCCACAGGAA|TCCGTATCTGGACCGCCATGTTAGGCCTTA
GTATGTAATTGCGCCGCATCCGGAGTTCGT|GAGGGAGTCAGAGATGAAATATATCACCAA
TTCGTGTTTAGGTATGTAATAGCATCCGGA|CCTGTACTCGCATAGAGAAACATATGATCC
TGCGAACGCCCGTAGGTTTCGTAAAGTCGA|CCGTCGAAGGATGCTGTAATAGTACCCCCT
ACCTCCCGTCGAAGGATGCTGTAATAGTAC|GAGTTCGTGTTTAGGTATGTAATAGGTATG
AGGTAGGTGCTGGCCACCTAGATGTACGGA|GAGTTCGTGTTTAGGTATGTAATAGCATCC
TGCTGTGCGGTAGAGAGGCCCGGGCATCCG|GGAGTTCGTGTTTAGGTATGTAATCGGAGT
GTTCGTGTTTAGGTATGTAATAGCATCCGG|TCCTGTACTCGCATAGAGAAACATATGATC
TCGCATCCGGAGTTCGTGTTTAGGTATGTA|ACAAATGCAAGAGGCATAACCAGGCGAGGA
AATTAGGTATGTAATGGAGCGCGAGTGAGG|AACGCCCGTAGGTTTCGTAAAGTCGAGGGT
CGGTAGAGAGGCCCGGGCATCCGGAGTTCG|GTGTTTAGGTATGTAATCGGAGTTCGTGTT
TTTTTACTACAATCGTTGCAATAAACTGGA|CCGAAAGTTTGATTAGAATGAATCTGACTT
CGGAGTTCGTGTTTAGGTATGTAATCCATA|AGTTCGTGTTTAGGTATGTAATTAGGTATG
GGGGATCCCCACTTGGGTCAATCCGGCGGG|TGTTTAGGTATGTAATTGCAGTTAGGTGAA
CCGGAGTTCGTGTTTAGGTATGTAATGGAT|CTTCTGCACCTTAGGCGCCCTGTGAGGGAC
AATCGGAGTTCGTGTTTAGGTATGTAATTC|ATGTAGGTGACATAGCGAGCTCCGCATCCG
TGGAGGCATCCGGAGTTCGTGTTTAGGTAT|TTGCATCCGGAGTTCGTGTTTAGGTATGTA
GTTGCATCCGGAGTTCGTGTTTAGGTATGT|TAATGACGTTGTTTTACTCTTCTGGGTGCG
TGCTGTAATAGTACCCCCTGGCAATCATGT|ATGTAATAGGTATGTAATTGCGCCGCATCC
GCGCCCTGTGAGGGACTACTCAGACTTCGC|TTCGTGTTTAGGTATGTAATAATCTACGAT
AGCTTTTAATCGACTTTGGTCCGAGAATCG|CACGCACAGTCCATTCGCCCATGCTGGCGC
TAGTACCCCCTGGCAATCATGTTATTACAC|GGTATGTAATTGCGCCGCATCCGGAGTTCG
TGTAATCGGAGTTCGTGTTTAGGTATGTAA|AGGATGTAGGTGACATAGCGAGCTCCGCAT
CGTGTTGCATCCGGAGTTCGTGTTTAGGTA|ATGTAATGACGTTGTTTTACTCTTCTGGGT
AAATCGCACAGTATGACTAAAACTAATTGA|GTAATGGAGCGCGAGTGAGGTAAGATTAGC
GGTGCTGGCCACCTAGATGTACGGACCCGT|CGTGTTTAGGTATGTAATAGCATCCGGAGT
TACCCCCTGGCAATCATGTTATTACACAAA|ATGTAATTGCGCCGCATCCGGAGTTCGTGT
AGGGACTACTCAGACTTCGCCCCATTATTT|GGTATGTAATAATCTACGATGCCCGCATCC
CTCGCATAGAGAAACATATGATCCCATGGA|ATCGAGCCTCGATACAGTTTACTATCTGCA
CGAGAATCGTTAGTGGCTTTAGGTAGGTGC|TGCTGGCGCCTCGGCATCCGGAGTTCGTGT
AATCTACGATGCCCGCATCCGGAGTTCGTG|CGGGCATCCGGAGTTCGTGTTTAGGTATGT
CGTGTTTAGGTATGTAATCGGAGTTCGTGT|CATAACCAGGCGAGGATGTAGGTGACATAG
TAATGGATCGAGCCTCGATACAGTTTACTA|TGAGGGACTACTCAGACTTCGCCCCATTAT
ACAGTTTACTATCTGCATACCCAATTATTC|CGCCCCATTATTTGGTATCCCTATGGAGGC
ATCACGCACAGTCCATTCGCCCATGCTGGC|AATCGTTGCAATAAACTGGAGGCCAGCCTT
GGGCATCCGGAGTTCGTGTTTAGGTATGTA|AATCGGAGTTCGTGTTTAGGTATGTAATTC
TACAGTTTACTATCTGCATACCCAATTATT|TCGCCCCATTATTTGGTATCCCTATGGAGG
TTAGAATGAATCTGACTTGCATCCGGAGTT|GAACAGCGGCTTGGGTGTCAGGCTTCTGCA
ATGTAGGTGACATAGCGAGCTCCGCATCCG|TTCGTGTTTAGGTATGTAATCATAACGCCG
TAGCGCTTTGACCGTTGCTGTGCGGTAGAG|CTAGGCATCGCATCCGGAGTTCGTGTTTAG
TCGTGTTTAGGTATGTAATCATAACGCCGT|GTATGTAATCCTTGCATTCCTGTAATCCGT
CCAATTATTCGGTACTCGTGCAATTTCGAG|CTATGGAGGCATCCGGAGTTCGTGTTTAGG
AAACATATGATCCCATGGACTAGAATAACC|ATACAGTTTACTATCTGCATACCCAATTAT
CATCCGGAGTTCGTGTTTAGGTATGTAATG|CGGAGTTCGTGTTTAGGTATGTAATTCACG
ACTTGCATCCGGAGTTCGTGTTTAGGTATG|GTGTCAGGCTTCTGCACCTTAGGCGCCCTG
ACCTCCTAGGCATCGCATCCGGAGTTCGTG|TCATGTTATTACACAAATGCAAGAGGCATA
AACCTCCTAGGCATCGCATCCGGAGTTCGT|ATCATGTTATTACACAAATGCAAGAGGCAT
GCTTTAGGTAGGTGCTGGCCACCTAGATGT|ATCCGGAGTTCGTGTTTAGGTATGTAATAG
TAATTGCGCCGCATCCGGAGTTCGTGTTTA|AGTCAGAGATGAAATATATCACCAATGTAA
ATAACCAGTGTGGCAGATATGTGGAGTATC|AATTATTCGGTACTCGTGCAATTTCGAGTA
ATGTCGCGTCCGGAGACCTCCCGTCGAAGG|TCGTGTTTGCATCCGGAGTTCGTGTTTAGG
AATGACGTTGTTTTACTCTTCTGGGTGCGA|CACGTATGTCGCGTCCGGAGACCTCCCGTC
CTGACTTGCATCCGGAGTTCGTGTTTAGGT|TGGGTGTCAGGCTTCTGCACCTTAGGCGCC
GACCGTTGCTGTGCGGTAGAGAGGCCCGGG|GCATCCGGAGTTCGTGTTTAGGTATGTAAT
AATAGTACCCCCTGGCAATCATGTTATTAC|TAGGTATGTAATTGCGCCGCATCCGGAGTT
GATTAGCGCTTTGACCGTTGCTGTGCGGTA|CTCCTAGGCATCGCATCCGGAGTTCGTGTT
AATTTCGAGTATTGGTCCACTATCACGAAC|GTGTTTAGGTATGTAATCCATAAATCGCAC
TATGTAATCGGAGTTCGTGTTTAGGTATGT|CGAGGATGTAGGTGACATAGCGAGCTCCGC
TGTAATCCATAAATCGCACAGTATGACTAA|AATTAGGTATGTAATGGAGCGCGAGTGAGG
AGGTGAAGCTACCAAATTTTTACTACAATC|TATGTGGAGTATCAACCCGAAAGTTTGATT
ATTCGCCCATGCTGGCGCCTCGGCATCCGG|ACTGGAGGCCAGCCTTTAAAAGAGGGGTAA
ATTATTTGGTATCCCTATGGAGGCATCCGG|CGCATCCGGAGTTCGTGTTGCATCCGGAGT
CATCGCATCCGGAGTTCGTGTTTAGGTATG|ACACAAATGCAAGAGGCATAACCAGGCGAG
TCGTTGCAATAAACTGGAGGCCAGCCTTTA|TTAGAATGAATCTGACTTGCATCCGGAGTT
GGTATGTAATTGCAGTTAGGTGAAGCTACC|ATAACCAGTGTGGCAGATATGTGGAGTATC
GGTCAATCCGGCGGGTCTGCGCCTTCCGAG|TTGCAGTTAGGTGAAGCTACCAAATTTTTA
ATGTAATCGGAGTTCGTGTTTAGGTATGTA|GAGGATGTAGGTGACATAGCGAGCTCCGCA
GATGTAGGTGACATAGCGAGCTCCGCATCC|GTTCGTGTTTAGGTATGTAATCATAACGCC
CGAACAGCGGCTTGGGTGTCAGGCTTCTGC|CGCACAGTATGACTAAAACTAATTGATGCA
TCGCGTCCGGAGACCTCCCGTCGAAGGATG|TGTTTGCATCCGGAGTTCGTGTTTAGGTAT
CGTGTTTAGGTATGTAATGGATCGAGCCTC|CCTTAGGCGCCCTGTGAGGGACTACTCAGA
TTAGGTATGTAATTCACGTATGTCGCGTCC|CGAGCTCCGCATCCGGAGTTCGTGTTTGCA
AAAACTAATTGATGCATCCGGAGTTCGTGT|GGTAAGATTAGCGCTTTGACCGTTGCTGTG
GCACAGTATGACTAAAACTAATTGATGCAT|GGAGCGCGAGTGAGGTAAGATTAGCGCTTT
TGTTTTACTCTTCTGGGTGCGAACGCCCGT|TCGCGTCCGGAGACCTCCCGTCGAAGGATG
TATTCGGTACTCGTGCAATTTCGAGTATTG|GAGGCATCCGGAGTTCGTGTTTAGGTATGT
GGAGTTCGTGTTTAGGTATGTAATGGATCG|TCTGCACCTTAGGCGCCCTGTGAGGGACTA
CGCGTGTCCCCCCACAGGAATCACGGTTGT|GACCGCCATGTTAGGCCTTACAACGGGAAT
GTGAAGCTACCAAATTTTTACTACAATCGT|TGTGGAGTATCAACCCGAAAGTTTGATTAG
TTCGTAAAGTCGAGGGTAACCTCCTAGGCA|AATAGTACCCCCTGGCAATCATGTTATTAC
GATCCCCACTTGGGTCAATCCGGCGGGTCT|TTAGGTATGTAATTGCAGTTAGGTGAAGCT
TGTAATGACGTTGTTTTACTCTTCTGGGTG|ATTCACGTATGTCGCGTCCGGAGACCTCCC
GGAGTTCGTGTTTAGGTATGTAATTGCAGT|TCCCATGGACTAGAATAACCAGTGTGGCAG
TTAGGTAGGTGCTGGCCACCTAGATGTACG|CGGAGTTCGTGTTTAGGTATGTAATAGCAT
AGGTATGTAATAGGTATGTAATTGCGCCGC|GTTGTCCGCATTAGAGGGAGTCAGAGATGA
GAGGCATAACCAGGCGAGGATGTAGGTGAC|TATGTAATCGCATCCGGAGTTCGTGTTTAG
TGGATCGAGCCTCGATACAGTTTACTATCT|GGGACTACTCAGACTTCGCCCCATTATTTG
TCGCCCCATTATTTGGTATCCCTATGGAGG|CGATGCCCGCATCCGGAGTTCGTGTTGCAT
GATACAGTTTACTATCTGCATACCCAATTA|CTTCGCCCCATTATTTGGTATCCCTATGGA
GGCCACCTAGATGTACGGACCCGTCTCGGG|TAGGTATGTAATAGCATCCGGAGTTCGTGT
ACTCGCATAGAGAAACATATGATCCCATGG|GATCGAGCCTCGATACAGTTTACTATCTGC
CGGAGTTCGTGTTTAGGTATGTAATTCACG|TAGGTGACATAGCGAGCTCCGCATCCGGAG
GTTCGTGTTTAGGTATGTAATTAGGTATGT|TTTACTCTTCTGGGTGCGAACGCCCGTAGG
TTGGGTGTCAGGCTTCTGCACCTTAGGCGC|ACTAAAACTAATTGATGCATCCGGAGTTCG
GATCGAGCCTCGATACAGTTTACTATCTGC|GACTACTCAGACTTCGCCCCATTATTTGGT
CCTATGGAGGCATCCGGAGTTCGTGTTTAG|CGTGTTGCATCCGGAGTTCGTGTTTAGGTA
ACCAAATTTTTACTACAATCGTTGCAATAA|ATCAACCCGAAAGTTTGATTAGAATGAATC
ATGATCCCATGGACTAGAATAACCAGTGTG|TTTACTATCTGCATACCCAATTATTCGGTA
CCCCCACAGGAATCACGGTTGTCCGCATTA|TGTTAGGCCTTACAACGGGAATACGTGCGA
AGTGAGGTAAGATTAGCGCTTTGACCGTTG|CGAGGGTAACCTCCTAGGCATCGCATCCGG
TAGGTATGTAATAGGTATGTAATTGCGCCG|GGTTGTCCGCATTAGAGGGAGTCAGAGATG
AATTTTTACTACAATCGTTGCAATAAACTG|ACCCGAAAGTTTGATTAGAATGAATCTGAC
TGGGTGTCAGGCTTCTGCACCTTAGGCGCC|CTAAAACTAATTGATGCATCCGGAGTTCGT
ATGGAGCGCGAGTGAGGTAAGATTAGCGCT|TTCGTAAAGTCGAGGGTAACCTCCTAGGCA
GTATGTAATCGGAGTTCGTGTTTAGGTATG|GCGAGGATGTAGGTGACATAGCGAGCTCCG
TTACTCTTCTGGGTGCGAACGCCCGTAGGT|GTCCGGAGACCTCCCGTCGAAGGATGCTGT
CCCATGGACTAGAATAACCAGTGTGGCAGA|TATCTGCATACCCAATTATTCGGTACTCGT
CATTCGCCCATGCTGGCGCCTCGGCATCCG|AACTGGAGGCCAGCCTTTAAAAGAGGGGTA
TTGGTATCCCTATGGAGGCATCCGGAGTTC|CCGGAGTTCGTGTTGCATCCGGAGTTCGTG
GATGCCCGCATCCGGAGTTCGTGTTGCATC|CCGGAGTTCGTGTTTAGGTATGTAATGACG
TGCAATAAACTGGAGGCCAGCCTTTAAAAG|AATGAATCTGACTTGCATCCGGAGTTCGTG
GGTATGTAATTCACGTATGTCGCGTCCGGA|GCTCCGCATCCGGAGTTCGTGTTTGCATCC
CGGAGTTCGTGTTTAGGTATGTAATCGCAT|ATATCACCAATGTAACGCATCCGGAGTTCG
GAGTTCGTGTTTAGGTATGTAATAGCATCC|AGTCCTGTACTCGCATAGAGAAACATATGA
CGGACCCGTCTCGGGGATCCCCACTTGGGT|ATCCGGAGTTCGTGTTTAGGTATGTAATTG
ATCCGGAGTTCGTGTTTAGGTATGTAATCC|CGGAGTTCGTGTTTAGGTATGTAATTAGGT
GCGTGTCCCCCCACAGGAATCACGGTTGTC|ACCGCCATGTTAGGCCTTACAACGGGAATA
GAGTTCGTGTTTAGGTATGTAATAGGTATG|ACAGGAATCACGGTTGTCCGCATTAGAGGG
GACCCGTCTCGGGGATCCCCACTTGGGTCA|CCGGAGTTCGTGTTTAGGTATGTAATTGCA
GGAGACCTCCCGTCGAAGGATGCTGTAATA|TCCGGAGTTCGTGTTTAGGTATGTAATAGG
CCTGTGAGGGACTACTCAGACTTCGCCCCA|TGTTTAGGTATGTAATAATCTACGATGCCC
GTATGTCGCGTCCGGAGACCTCCCGTCGAA|GTTCGTGTTTGCATCCGGAGTTCGTGTTTA
GGAGTTCGTGTTTAGGTATGTAATTAGGTA|TGTTTTACTCTTCTGGGTGCGAACGCCCGT
GGACTAGAATAACCAGTGTGGCAGATATGT|GCATACCCAATTATTCGGTACTCGTGCAAT
GTGTTTAGGTATGTAATTGCAGTTAGGTGA|GACTAGAATAACCAGTGTGGCAGATATGTG
CGTGTTTAGGTATGTAATCGCATCCGGAGT|CAATGTAACGCATCCGGAGTTCGTGTTTAG
AGGTATGTAATTAGGTATGTAATGGAGCGC|TGGGTGCGAACGCCCGTAGGTTTCGTAAAG
ATTGCAGTTAGGTGAAGCTACCAAATTTTT|TGTGGCAGATATGTGGAGTATCAACCCGAA
GTTCGTGTTTAGGTATGTAATTGCAGTTAG|CATGGACTAGAATAACCAGTGTGGCAGATA
GCCCTGTGAGGGACTACTCAGACTTCGCCC|CGTGTTTAGGTATGTAATAATCTACGATGC
TTGCATCCGGAGTTCGTGTTTAGGTATGTA|GTCAGGCTTCTGCACCTTAGGCGCCCTGTG
GTCGAAGGATGCTGTAATAGTACCCCCTGG|TGTTTAGGTATGTAATAGGTATGTAATTGC
TATGATCCCATGGACTAGAATAACCAGTGT|GTTTACTATCTGCATACCCAATTATTCGGT
GTTATTACACAAATGCAAGAGGCATAACCA|CCGGAGTTCGTGTTTAGGTATGTAATCGCA
TAATAGGTATGTAATTGCGCCGCATCCGGA|GCATTAGAGGGAGTCAGAGATGAAATATAT
ATGTAATTGCGCCGCATCCGGAGTTCGTGT|GGGAGTCAGAGATGAAATATATCACCAATG
CTCCCGTCGAAGGATGCTGTAATAGTACCC|GTTCGTGTTTAGGTATGTAATAGGTATGTA
TACTCGCATAGAGAAACATATGATCCCATG|GGATCGAGCCTCGATACAGTTTACTATCTG
CGTGTTTAGGTATGTAATTCACGTATGTCG|CATAGCGAGCTCCGCATCCGGAGTTCGTGT
GATGCTGTAATAGTACCCCCTGGCAATCAT|GTATGTAATAGGTATGTAATTGCGCCGCAT
GAGACCTCCCGTCGAAGGATGCTGTAATAG|CCGGAGTTCGTGTTTAGGTATGTAATAGGT
CCAAATTTTTACTACAATCGTTGCAATAAA|TCAACCCGAAAGTTTGATTAGAATGAATCT
ATGTAATTAGGTATGTAATGGAGCGCGAGT|TGCGAACGCCCGTAGGTTTCGTAAAGTCGA
CGTTGTTTTACTCTTCTGGGTGCGAACGCC|ATGTCGCGTCCGGAGACCTCCCGTCGAAGG
AATCGACTTTGGTCCGAGAATCGTTAGTGG|AGTCCATTCGCCCATGCTGGCGCCTCGGCA
CAGGTCGCGTGTCCCCCCACAGGAATCACG|ATCTGGACCGCCATGTTAGGCCTTACAACG
ATCGACTTTGGTCCGAGAATCGTTAGTGGC|GTCCATTCGCCCATGCTGGCGCCTCGGCAT
CGCATCCGGAGTTCGTGTTTGCATCCGGAG|TAACGCCGTCAGGTCGCGTGTCCCCCCACA
GTTTAGGTATGTAATAGGTATGTAATTGCG|CACGGTTGTCCGCATTAGAGGGAGTCAGAG
AATAAACTGGAGGCCAGCCTTTAAAAGAGG|GAATCTGACTTGCATCCGGAGTTCGTGTTT
CGATACAGTTTACTATCTGCATACCCAATT|ACTTCGCCCCATTATTTGGTATCCCTATGG
CCACTATCACGAACAGCGGCTTGGGTGTCA|TCCATAAATCGCACAGTATGACTAAAACTA
GTTTAGGTATGTAATGGATCGAGCCTCGAT|TAGGCGCCCTGTGAGGGACTACTCAGACTT
AGTTAGGTGAAGCTACCAAATTTTTACTAC|CAGATATGTGGAGTATCAACCCGAAAGTTT
AGCCTCGATACAGTTTACTATCTGCATACC|CTCAGACTTCGCCCCATTATTTGGTATCCC
TCCTGTACTCGCATAGAGAAACATATGATC|GTAATGGATCGAGCCTCGATACAGTTTACT
GGGGTAAGTCCTGTACTCGCATAGAGAAAC|TTAGGTATGTAATGGATCGAGCCTCGATAC
CCCGGGCATCCGGAGTTCGTGTTTAGGTAT|TGTAATCGGAGTTCGTGTTTAGGTATGTAA
GACTTCGCCCCATTATTTGGTATCCCTATG|TCTACGATGCCCGCATCCGGAGTTCGTGTT
TAATCGACTTTGGTCCGAGAATCGTTAGTG|CAGTCCATTCGCCCATGCTGGCGCCTCGGC
CCAGTGTGGCAGATATGTGGAGTATCAACC|ATTCGGTACTCGTGCAATTTCGAGTATTGG
ATGTGGAGTATCAACCCGAAAGTTTGATTA|CAATTTCGAGTATTGGTCCACTATCACGAA
GTGTTGCATCCGGAGTTCGTGTTTAGGTAT|TGTAATGACGTTGTTTTACTCTTCTGGGTG
ACCCCCTGGCAATCATGTTATTACACAAAT|TGTAATTGCGCCGCATCCGGAGTTCGTGTT
GTGACATAGCGAGCTCCGCATCCGGAGTTC|TTTAGGTATGTAATCATAACGCCGTCAGGT
GGTCCACTATCACGAACAGCGGCTTGGGTG|TAATCCATAAATCGCACAGTATGACTAAAA
TCGTGTTTAGGTATGTAATCGGAGTTCGTG|GCATAACCAGGCGAGGATGTAGGTGACATA
TCCGGAGTTCGTGTTTAGGTATGTAATAAT|TGACCGTTGCTGTGCGGTAGAGAGGCCCGG
AATGAATCTGACTTGCATCCGGAGTTCGTG|AGCGGCTTGGGTGTCAGGCTTCTGCACCTT
TGGCTTTAGGTAGGTGCTGGCCACCTAGAT|GCATCCGGAGTTCGTGTTTAGGTATGTAAT
GTAACCTCCTAGGCATCGCATCCGGAGTTC|CAATCATGTTATTACACAAATGCAAGAGGC
CATCCGGAGTTCGTGTTTAGGTATGTAATC|TCGTGTTTAGGTATGTAATCCTTGCATTCC
ATCCGGAGTTCGTGTTTGCATCCGGAGTTC|CGCCGTCAGGTCGCGTGTCCCCCCACAGGA
GTATGTAATAGGTATGTAATTGCGCCGCAT|TGTCCGCATTAGAGGGAGTCAGAGATGAAA
CCCGTAGGTTTCGTAAAGTCGAGGGTAACC|GGATGCTGTAATAGTACCCCCTGGCAATCA
CCATTCGCCCATGCTGGCGCCTCGGCATCC|AAACTGGAGGCCAGCCTTTAAAAGAGGGGT
CGGAGTTCGTGTTTAGGTATGTAATTGCAG|ATCCCATGGACTAGAATAACCAGTGTGGCA
TAGGTATGTAATTCACGTATGTCGCGTCCG|GAGCTCCGCATCCGGAGTTCGTGTTTGCAT
CAGGAATCACGGTTGTCCGCATTAGAGGGA|GCCTTACAACGGGAATACGTGCGATCTATT
AGGATGCTGTAATAGTACCCCCTGGCAATC|AGGTATGTAATAGGTATGTAATTGCGCCGC
TTGATTAGAATGAATCTGACTTGCATCCGG|TCACGAACAGCGGCTTGGGTGTCAGGCTTC
TGTAATAGTACCCCCTGGCAATCATGTTAT|TAATAGGTATGTAATTGCGCCGCATCCGGA
CAACCCGAAAGTTTGATTAGAATGAATCTG|ATTGGTCCACTATCACGAACAGCGGCTTGG
GCATCCGGAGTTCGTGTTTAGGTATGTAAT|AAATGCAAGAGGCATAACCAGGCGAGGATG
TTATCACGCACAGTCCATTCGCCCATGCTG|ACAATCGTTGCAATAAACTGGAGGCCAGCC
GTATGTAATGGATCGAGCCTCGATACAGTT|CCCTGTGAGGGACTACTCAGACTTCGCCCC
GATTAGAATGAATCTGACTTGCATCCGGAG|ACGAACAGCGGCTTGGGTGTCAGGCTTCTG
GTTCGTGTTTAGGTATGTAATAATCTACGA|TTGCTGTGCGGTAGAGAGGCCCGGGCATCC
TTTTACTCTTCTGGGTGCGAACGCCCGTAG|GCGTCCGGAGACCTCCCGTCGAAGGATGCT
GCTTCTGCACCTTAGGCGCCCTGTGAGGGA|TTGATGCATCCGGAGTTCGTGTTTAGGTAT
CCGCATCCGGAGTTCGTGTTTAGGTATGTA|ATGAAATATATCACCAATGTAACGCATCCG
CAGGCTTCTGCACCTTAGGCGCCCTGTGAG|TAATTGATGCATCCGGAGTTCGTGTTTAGG
AACGCCGTCAGGTCGCGTGTCCCCCCACAG|TAATCCGTATCTGGACCGCCATGTTAGGCC
AGAGAGGCCCGGGCATCCGGAGTTCGTGTT|TTAGGTATGTAATCGGAGTTCGTGTTTAGG
GGATCGAGCCTCGATACAGTTTACTATCTG|GGACTACTCAGACTTCGCCCCATTATTTGG
GCATCCGGAGTTCGTGTTTAGGTATGTAAT|AGGGGTAAGTCCTGTACTCGCATAGAGAAA
AGTTTGATTAGAATGAATCTGACTTGCATC|CTATCACGAACAGCGGCTTGGGTGTCAGGC
AATTGCGCCGCATCCGGAGTTCGTGTTTAG|GTCAGAGATGAAATATATCACCAATGTAAC
GAACGCCCGTAGGTTTCGTAAAGTCGAGGG|TCGAAGGATGCTGTAATAGTACCCCCTGGC
CGTGTTTAGGTATGTAATCATAACGCCGTC|TATGTAATCCTTGCATTCCTGTAATCCGTA
GTTCGTGTTTAGGTATGTAATCATAACGCC|AGGTATGTAATCCTTGCATTCCTGTAATCC
ATGTAATTGCAGTTAGGTGAAGCTACCAAA|ACCAGTGTGGCAGATATGTGGAGTATCAAC
GTATGTAATCCATAAATCGCACAGTATGAC|TGTAATTAGGTATGTAATGGAGCGCGAGTG
CTAATTGATGCATCCGGAGTTCGTGTTTAG|AGATTAGCGCTTTGACCGTTGCTGTGCGGT
ATCGCATCCGGAGTTCGTGTTTAGGTATGT|CACAAATGCAAGAGGCATAACCAGGCGAGG
TGCGCCGCATCCGGAGTTCGTGTTTAGGTA|AGAGATGAAATATATCACCAATGTAACGCA
GAATAACCAGTGTGGCAGATATGTGGAGTA|CCAATTATTCGGTACTCGTGCAATTTCGAG
GTGTTTGCATCCGGAGTTCGTGTTTAGGTA|CGCGTGTCCCCCCACAGGAATCACGGTTGT
ACTAAAACTAATTGATGCATCCGGAGTTCG|TGAGGTAAGATTAGCGCTTTGACCGTTGCT
TCGTGTTTAGGTATGTAATCGCATCCGGAG|CCAATGTAACGCATCCGGAGTTCGTGTTTA
TCGCACAGTATGACTAAAACTAATTGATGC|ATGGAGCGCGAGTGAGGTAAGATTAGCGCT
TATGTAATTCACGTATGTCGCGTCCGGAGA|TCCGCATCCGGAGTTCGTGTTTGCATCCGG
TCGTGTTTAGGTATGTAATTGCAGTTAGGT|TGGACTAGAATAACCAGTGTGGCAGATATG
TTAGGTATGTAATTAGGTATGTAATGGAGC|TCTGGGTGCGAACGCCCGTAGGTTTCGTAA
TGTAGGTGACATAGCGAGCTCCGCATCCGG|TCGTGTTTAGGTATGTAATCATAACGCCGT
TCTGACTTGCATCCGGAGTTCGTGTTTAGG|TTGGGTGTCAGGCTTCTGCACCTTAGGCGC
CCGTAGGTTTCGTAAAGTCGAGGGTAACCT|GATGCTGTAATAGTACCCCCTGGCAATCAT
AAAAGAGGGGTAAGTCCTGTACTCGCATAG|TCGTGTTTAGGTATGTAATGGATCGAGCCT
AGGCATCGCATCCGGAGTTCGTGTTTAGGT|ATTACACAAATGCAAGAGGCATAACCAGGC
GCCAGCCTTTAAAAGAGGGGTAAGTCCTGT|CATCCGGAGTTCGTGTTTAGGTATGTAATG
GTAGGTGACATAGCGAGCTCCGCATCCGGA|CGTGTTTAGGTATGTAATCATAACGCCGTC
GCGGCTTGGGTGTCAGGCTTCTGCACCTTA|GTATGACTAAAACTAATTGATGCATCCGGA
TGTAATTCACGTATGTCGCGTCCGGAGACC|CGCATCCGGAGTTCGTGTTTGCATCCGGAG
AATAATCTACGATGCCCGCATCCGGAGTTC|GCCCGGGCATCCGGAGTTCGTGTTTAGGTA
TCGATACAGTTTACTATCTGCATACCCAAT|GACTTCGCCCCATTATTTGGTATCCCTATG
CGCCCATGCTGGCGCCTCGGCATCCGGAGT|GGAGGCCAGCCTTTAAAAGAGGGGTAAGTC
GTTATCACGCACAGTCCATTCGCCCATGCT|TACAATCGTTGCAATAAACTGGAGGCCAGC
AGGTATGTAATGGATCGAGCCTCGATACAG|CGCCCTGTGAGGGACTACTCAGACTTCGCC
GTATGTAATTGCAGTTAGGTGAAGCTACCA|TAACCAGTGTGGCAGATATGTGGAGTATCA
ATGACGTTGTTTTACTCTTCTGGGTGCGAA|ACGTATGTCGCGTCCGGAGACCTCCCGTCG
TTAGCGCTTTGACCGTTGCTGTGCGGTAGA|CCTAGGCATCGCATCCGGAGTTCGTGTTTA
CTCTTCTGGGTGCGAACGCCCGTAGGTTTC|CGGAGACCTCCCGTCGAAGGATGCTGTAAT
AGTTCGTGTTTAGGTATGTAATTGCAGTTA|CCATGGACTAGAATAACCAGTGTGGCAGAT
GGTAACCTCCTAGGCATCGCATCCGGAGTT|GCAATCATGTTATTACACAAATGCAAGAGG
TAGGTATGTAATTAGGTATGTAATGGAGCG|CTGGGTGCGAACGCCCGTAGGTTTCGTAAA
GTATGTAATCATAACGCCGTCAGGTCGCGT|CTTGCATTCCTGTAATCCGTATCTGGACCG
TGATGCATCCGGAGTTCGTGTTTAGGTATG|AGCGCTTTGACCGTTGCTGTGCGGTAGAGA
GGGTAAGTCCTGTACTCGCATAGAGAAACA|TAGGTATGTAATGGATCGAGCCTCGATACA
AAGATTAGCGCTTTGACCGTTGCTGTGCGG|ACCTCCTAGGCATCGCATCCGGAGTTCGTG
CCGAGAATCGTTAGTGGCTTTAGGTAGGTG|ATGCTGGCGCCTCGGCATCCGGAGTTCGTG
GCATCCGGAGTTCGTGTTTAGGTATGTAAT|TCGGAGTTCGTGTTTAGGTATGTAATTCAC
GCGCCTCGGCATCCGGAGTTCGTGTTTAGG|TTTAAAAGAGGGGTAAGTCCTGTACTCGCA
CGCATCCGGAGTTCGTGTTTAGGTATGTAA|TGAAATATATCACCAATGTAACGCATCCGG
TGCATACCCAATTATTCGGTACTCGTGCAA|GGTATCCCTATGGAGGCATCCGGAGTTCGT
CGCCGTCAGGTCGCGTGTCCCCCCACAGGA|ATCCGTATCTGGACCGCCATGTTAGGCCTT
AGTTCGTGTTTAGGTATGTAATCCATAAAT|TCGTGTTTAGGTATGTAATTAGGTATGTAA
CGCTTTGACCGTTGCTGTGCGGTAGAGAGG|GGCATCGCATCCGGAGTTCGTGTTTAGGTA
GTAATTAGGTATGTAATGGAGCGCGAGTGA|CGAACGCCCGTAGGTTTCGTAAAGTCGAGG
ACTAATTGATGCATCCGGAGTTCGTGTTTA|AAGATTAGCGCTTTGACCGTTGCTGTGCGG
TTAGGTGAAGCTACCAAATTTTTACTACAA|GATATGTGGAGTATCAACCCGAAAGTTTGA
TATCACGAACAGCGGCTTGGGTGTCAGGCT|TAAATCGCACAGTATGACTAAAACTAATTG
AGGCGAGGATGTAGGTGACATAGCGAGCTC|ATCCGGAGTTCGTGTTTAGGTATGTAATCA
CGCCCTGTGAGGGACTACTCAGACTTCGCC|TCGTGTTTAGGTATGTAATAATCTACGATG
GCCTTCCGAGGGTTATCACGCACAGTCCAT|CAAATTTTTACTACAATCGTTGCAATAAAC
CGTGTTTGCATCCGGAGTTCGTGTTTAGGT|TCGCGTGTCCCCCCACAGGAATCACGGTTG
GGTACTCGTGCAATTTCGAGTATTGGTCCA|ATCCGGAGTTCGTGTTTAGGTATGTAATCC
GTCCCCCCACAGGAATCACGGTTGTCCGCA|CCATGTTAGGCCTTACAACGGGAATACGTG
CAGTTAGGTGAAGCTACCAAATTTTTACTA|GCAGATATGTGGAGTATCAACCCGAAAGTT
ATAGAGAAACATATGATCCCATGGACTAGA|GCCTCGATACAGTTTACTATCTGCATACCC
CGATGCCCGCATCCGGAGTTCGTGTTGCAT|TCCGGAGTTCGTGTTTAGGTATGTAATGAC
GACGTTGTTTTACTCTTCTGGGTGCGAACG|GTATGTCGCGTCCGGAGACCTCCCGTCGAA
AGGAATCACGGTTGTCCGCATTAGAGGGAG|CCTTACAACGGGAATACGTGCGATCTATTT
TATGACTAAAACTAATTGATGCATCCGGAG|CGAGTGAGGTAAGATTAGCGCTTTGACCGT
GCAATAAACTGGAGGCCAGCCTTTAAAAGA|ATGAATCTGACTTGCATCCGGAGTTCGTGT
GGTATGTAATCCATAAATCGCACAGTATGA|ATGTAATTAGGTATGTAATGGAGCGCGAGT
GGAATCACGGTTGTCCGCATTAGAGGGAGT|CTTACAACGGGAATACGTGCGATCTATTTC
GTATGTAATGACGTTGTTTTACTCTTCTGG|GTAATTCACGTATGTCGCGTCCGGAGACCT
TGTTATTACACAAATGCAAGAGGCATAACC|TCCGGAGTTCGTGTTTAGGTATGTAATCGC
ATAAATCGCACAGTATGACTAAAACTAATT|ATGTAATGGAGCGCGAGTGAGGTAAGATTA
